arha	arh1<kqw_prawyayaH:ac><lifgam:puM><XAwuH:arhaz><gaNaH:BvAxiH>
prawIkRA	prawi_IkR1<kqw_prawyayaH:A><lifgam:swrI><XAwuH:IkRaz><gaNaH:BvAxiH>
prawiRTiwa	pra_sWA1<kqw_prawyayaH:kwa><lifgam:napuM><XAwuH:RTA><gaNaH:BvAxiH>
kAriwavawI	kq3_Nic<kqw_prawyayaH:kwavawu><lifgam:swrI><XAwuH:dukqF><gaNaH:curAxiH>
upasWApiwavaw	upa_sWA1_Nic<kqw_prawyayaH:kwavawu><lifgam:puM><XAwuH:kaWa><gaNaH:curAxiH>
xarSayaw	xqS1_Nic<kqw_prawyayaH:Sawq_lat><lifgam:puM><XAwuH:XqSizr><gaNaH:BvAxiH>
kaWayaw	kaWa1<kqw_prawyayaH:Sawq_lat><lifgam:puM><XAwuH:kaWa><gaNaH:curAxiH>
nirxiRtavaw	nir_xiS1<kqw_prawyayaH:kwa><XAwuH:xiS><gaNaH:wuxAxiH>
pravqwwa	pra_vqw1<kqw_prawyayaH:kwa><lifgam:puM><XAwuH:vqwuz><gaNaH:BvAxiH>/pra_vqw1<kqw_prawyayaH:kwa><lifgam:napuM><XAwuH:vqwuz><gaNaH:BvAxiH>
pravyaWiw	pra_vyaW1<kqw_prawyayaH:kwa><XAwuH:vyaWaz><gaNaH:BvAxiH>
SqNvaw	Sru1<kqw_prawyayaH:Sawq_lat><lifgam:puM><XAwuH:Sru><gaNaH:BvAxiH>
varwsyan	vqX1<kqw_prawyayaH:Sawq_lat><lifgam:puM><XAwuH:vqXuz><gaNaH:BvAxiH>
upekRya	upa_IkR1<kqw_prawyayaH:yaw><lifgam:puM><XAwuH:IkRaz><gaNaH:BvAxiH>
uwwiRTamAna	uw_sWA1<kqw_prawyayaH:SAnac><lifgam:puM><XAwuH:RTA><gaNaH:BvAxiH>
snapiwA	RnA1_Nic<kqw_prawyayaH:kwa><lifgam:swrI><XAwuH:RnA><gaNaH:axAxiH>
prawiRTAsu	pra_sWA1_san<kqw_prawyayaH:u><lifgam:puM><XAwuH:RTA><gaNaH:BvAxiH>
jAjvalyamAnA	jval1_san<kqw_prawyayaH:SAnac><lifgam:puM><XAwuH:jvalaz><gaNaH:BvAxiH>
yiyakRamANa	yaj1_san<kqw_prawyayaH:SAnac><lifgam:puM><XAwuH:yajaz><gaNaH:BvAxiH>
samAgawa	sam_Af_gamL1<kqw_prawyayaH:kwa><lifgam:puM><XAwuH:gamL><gaNaH:BvAxiH>
anuXAviwa	anu_XAv1<kqw_prawyayaH:kwa><lifgam:puM><XAwuH:XAvuz><gaNaH:BvAxiH>
samavewa	sam_ava_I1<kqw_prawyayaH:kwa><lifgam:puM><XAwuH:If><gaNaH:xivAxiH>
saFjanayaw	sam_jan1<kqw_prawyayaH:Sawq_lat><lifgam:puM><XAwuH:janI><gaNaH:xivAxiH>
anupAlayaw	anu_pAl<kqw_prawyayaH:Sawq_lat><lifgam:puM><XAwuH:pAl><gaNaH:curAxiH>
KAxaw	KAx1<lifgam:puM><kqw_prawyayaH:Sawq_lat><XAwuH:KAxqz><gaNaH:BvAxiH>/KAx1<lifgam:napuM><kqw_prawyayaH:Sawq_lat><XAwuH:KAxqz><gaNaH:BvAxiH><level:0>
prakASana	pra_kAS1<lifgam:napuM><kqw_prawyayaH:lyut><XAwuH:kASqz><gaNaH:BvAxiH>/pra_kAS2<lifgam:napuM><kqw_prawyayaH:lyut><XAwuH:kASqz><gaNaH:xivAxiH><level:0>
saFjAwa	sam_jan3<lifgam:puM><kqw_prawyayaH:kwa><XAwuH:janIz><gaNaH:xivAxiH>
nipAwiwa	ni_paw1_Nic<lifgam:puM><kqw_prawyayaH:kwa><XAwuH:pawL><gaNaH:xivAxiH>
uxyawa	uw_yam1<lifgam:puM><kqw_prawyayaH:kwa><XAwuH:yamaz><gaNaH:BvAxiH>
Agawa	Af_gam1<lifgam:puM><kqw_prawyayaH:kwa><XAwuH:gamL><gaNaH:BvAxiH>
niveSiwA	ni_viS1<lifgam:swrI><kqw_prawyayaH:kwa><XAwuH:viS1><gaNaH:wuxAxiH>
nivexiwavaw	ni_vix1<lifgam:puM><kqw_prawyayaH:kwavawu><XAwuH:vixaz><gaNaH:axAxiH>
AjFApiwavaw	Af_jFA2_Nic<lifgam:puM><kqw_prawyayaH:kwavawu><XAwuH:jFA><gaNaH:kryAxiH>
ArabXavaw	Af_raB1<lifgam:puM><kqw_prawyayaH:kwavawu><XAwuH:gamL><gaNaH:BvAxiH>
Agawavaw	Af_gam1<lifgam:puM><kqw_prawyayaH:kwavawu><XAwuH:gamL><gaNaH:BvAxiH>
upekRiwavaw	upa_IkRa1<lifgam:puM><kqw_prawyayaH:kwavawu><XAwuH:IkRaz><gaNaH:BvAxiH>
SrAviwavaw	Sru1_Nic<lifgam:puM><kqw_prawyayaH:kwavawu><XAwuH:Sru><gaNaH:BvAxiH>
upasWiwa	upa_sWA1<lifgam:puM><kqw_prawyayaH:kwa><XAwuH:RTA1><gaNaH:BvAxiH>
vinASa	vi_naS1<lifgam:puM><kqw_prawyayaH:GaF><XAwuH:naS1><gaNaH:xivAxiH>
