abalAviprayukwaH	abalAviprayukwa<vargaH:nA><lifgam:puM><viBakwiH:1><vacanam:1><level:1>
aBijFAnaSAkunwalam	aBijFAnaSAkunwala<vargaH:nA><lifgam:napuM><viBakwiH:1><vacanam:1><level:1>
aBikruXyawi	aBi_kruX1<prayogaH:karwari><lakAraH:lat><puruRaH:pra><vacanam:1><paxI:parasmEpaxI><XAwuH:kruXa><gaNaH:xivAxiH><level:0>
aBilaRanwI	aBilaRaw<vargaH:nA><lifgam:swrI><viBakwiH:1><vacanam:1><level:1>
aBinanxyamAnA	aBinanxyamAnA<vargaH:nA><lifgam:swrI><viBakwiH:1><vacanam:1><level:1>
aBiniviSawe	aBi_ni_viS1<prayogaH:karwari><lakAraH:lat><puruRaH:pra><vacanam:1><paxI:AwmanepaxI><XAwuH:viSaz><gaNaH:BvAxiH><level:0>
aBirunXanwi	aBi_ruX1<prayogaH:karwari><lakAraH:lat><puruRaH:pra><vacanam:3><paxI:parasmEpaxI><XAwuH:ruXir><gaNaH:ruXAxiH><level:0>
aBivijvalanwi	aBi_vi_jval1<prayogaH:karwari><lakAraH:lat><puruRaH:pra><vacanam:3><paxI:parasmEpaxI><XAwuH:jvalaz><gaNaH:BvAxiH>
aBiXIyawe	aBi_XA1<prayogaH:karmaNi><lakAraH:lat><puruRaH:pra><vacanam:1><paxI:AwmanepaxI><XAwuH:duXAF><gaNaH:juhowyAxiH>/aBi_XI1<prayogaH:karwari><lakAraH:lat><puruRaH:pra><vacanam:1><paxI:AwmanepaxI><XAwuH:XIf><gaNaH:xivAxiH>
aByasUyawi	aBi_asUya<prayogaH:karwari><lakAraH:lat><puruRaH:pra><vacanam:1><paxI:parasmEpaxI>
aByavanxawa	aBi_vanx1<prayogaH:karwari><lakAraH:laf><puruRaH:pra><vacanam:1><paxI:AwmanepaxI><XAwuH:vaxiz><gaNaH:BvAxiH><level:0>
afgIkqwvA	afgI_kq3<vargaH:avy><kqw_prawyayaH:kwvA><XAwuH:dukq><gaNaH:wuwAxiH><level:0>
afgIkqwya	afgI_kq3<vargaH:avy><kqw_prawyayaH:lyap><XAwuH:dukqF><gaNaH:wuxAxiH><level:0>
afgIkuru	afgI_kq2<prayogaH:karwari><lakAraH:lot><puruRaH:ma><vacanam:1><paxI:parasmEpaxI><XAwuH:dukqF><gaNaH:wanAxiH><level:1>
AgawavAn	Agawavaw<vargaH:nA><lifgam:puM><viBakwiH:1><vacanam:1><level:1>
Ahvaya	Af_hve1<prayogaH:karwari><lakAraH:lot><puruRaH:ma><vacanam:1><paxI:parasmEpaxI><XAwuH:hveF><gaNaH:BvAxiH><level:1>
AhvayAmaH	Af_hve1<prayogaH:karwari><lakAraH:lat><puruRaH:u><vacanam:3><paxI:parasmEpaxI><XAwuH:hveF><gaNaH:BvAxiH><level:0>
Ahvayawi	Af_hve1<prayogaH:karwari><lakAraH:lat><puruRaH:pra><vacanam:1><paxI:parasmEpaxI><XAwuH:hveF><gaNaH:BvAxiH><level:1>
AkAraya	Af_kq3_Nic<prayogaH:karwari><lakAraH:lot><puruRaH:ma><vacanam:1><paxI:parasmEpaxI><XAwuH:dukqF><gaNaH:kryAxiH><level:0>
AkarNayaw	Af_karNa1<prayogaH:karwari><lakAraH:laf><puruRaH:pra><vacanam:1><paxI:parasmEpaxI><XAwuH:karNa><gaNaH:curAxiH><level:0>
aKixyamAnaH	aKixyamAna<vargaH:nA><lifgam:puM><viBakwiH:1><vacanam:1><level:1>
AkqwIni	Akqwi<vargaH:nA><lifgam:napuM><viBakwiH:2><vacanam:3>
akRakumAram	akRakumAra<vargaH:nA><lifgam:puM><viBakwiH:2><vacanam:1><level:1>
AkRipan	Af_kRip1<kqw_prawyayaH:Sawq_lat><XAwuH:kRipaz><gaNaH:BvAxiH><level:0><kqw_pratipadika:AkRipaw><vargaH:nA><lifgam:puM><viBakwiH:1><vacanam:1>
AkRipaw	Af_kRip1<prayogaH:karwari><lakAraH:laf><puruRaH:pra><vacanam:1><paxI:parasmEpaxI><XAwuH:kSipa><gaNaH:BvAxiH><level:1>
akRixanwe	akRixanwa<vargaH:nA><lifgam:puM><viBakwiH:7><vacanam:1><level:1>
akRixanwena	akRixanwa<vargaH:nA><lifgam:puM><viBakwiH:3><vacanam:1><level:1>
akshakumAram	akshakumAra<vargaH:nA><lifgam:puM><viBakwiH:2><vacanam:1><level:1>
amerikAyAm	amerikA<vargaH:nA<lifgam:swrI<viBakwiH:7><vacanam:1><level:1>
amuhyaw	muh1<prayogaH:karwari><lakAraH:laf><puruRaH:pra><vacanam:1><paxI:parasmEpaxI><XAwuH:muh><gaNaH:xivAxiH><level:1>
anekaxA	anekaxA<vargaH:avy><level:1>
AnIwavAn	AnIwavaw<vargaH:nA><lifgam:puM><viBakwiH:1><vacanam:1><level:1>
AnIwavanwaH	AnIwavaw<vargaH:nA><lifgam:puM><viBakwiH:1><vacanam:3><level:1>
anubanXAni	anubanXa<vargaH:nA><lifgam:napuM><viBakwiH:1><vacanam:3>
anubrUhi	anu_brU1<prayogaH:karwari><lakAraH:lot><puruRaH:ma><vacanam:1><paxI:parasmEpaxI><XAwuH:brUF><gaNaH:axAxiH><level:0>
anubuBURuH	anu_BU1_san<prayogaH:karwari><lakAraH:lit><puruRaH:pra><vacanam:3><paxI:parasmEpaxI><XAwuH:BU><gaNaH:BvAxiH><level:0>
anuprawimAx	anuprawima<vargaH:nA><lifgam:puM><viBakwiH:5><vacanam:1><level:1>
anuRajjawe	anu_sasj1<prayogaH:karwari><lakAraH:lat><puruRaH:pra><vacanam:1><paxI:AwmanepaxI><XAwuH:Rasjaz><gaNaH:BvAxiH>
anuSuSruma	anu_Sru1<prayogaH:karwari><lakAraH:lit><puruRaH:u><vacanam:3><paxI:parasmEpaxI><XAwuH:Sru><gaNaH:BvAxiH>
anuvarNayAmi	anu_varN1<prayogaH:karwari><lakAraH:lat><puruRaH:u><vacanam:1><paxI:parasmEpaxI><XAwuH:varNaz><gaNaH:curAxiH><level:1>
anuvarwayanwi	anu_vqw3<prayogaH:karwari><lakAraH:lat><puruRaH:pra><vacanam:3><paxI:parasmEpaxI><XAwuH:vqwu><gaNaH:curAxiH><level:0>
anuvarwayawi	anu_vqw3<prayogaH:karwari><lakAraH:lat><puruRaH:pra><vacanam:1><paxI:parasmEpaxI><XAwuH:vqwuz><gaNaH:curAxiH>
anuvarwiwavanwO	anu_vqw1<kqw_prawyayaH:kwavawu><XAwuH:vqwuz><gaNaH:BvAxiH><level:0><kqw_pratipadika:anuvarwiwavaw><vargaH:nA><lifgam:puM><viBakwiH:1><vacanam:2>
anuviXIyawe	anu_Xi1<prayogaH:karmaNi><lakAraH:lat><puruRaH:pra><vacanam:1><paxI:AwmanepaxI><XAwuH:Xi><gaNaH:wuxAxiH>
anuxarSayan	anuxarSayaw<kqw_prawyayaH:Sawq_lat><XAwuH:xqSizr><gaNaH:BvAxiH><level:0><kqw_pratipadika:anuxarSayaw><vargaH:nA><lifgam:puM><viBakwiH:1><vacanam:1>
anuXAviwa	anu_XAv1<lifgam:puM><kqw_prawyayaH:kwa><XAwuH:XAvuz><gaNaH:BvAxiH><level:0>
anuXAviwaH	anuXAviwa<vargaH:nA><lifgam:puM><viBakwiH:1><vacanam:1><level:1>
anvayufkwa	anu_yuj1<prayogaH:karwari><lakAraH:laf><puruRaH:pra><vacanam:1><paxI:parasmEpaxI><XAwuH:yuja><gaNaH:ruXAxiH><level:1>
anveSaNaM	anveSaNa<vargaH:nA><lifgam:napuM><viBakwiH:1><vacanam:1><level:1>
apAci	pac1<prayogaH:karmaNi><lakAraH:lqf><puruRaH:pra><vacanam:1><paxI:AwmanepaxI><XAwuH:dupacaR><gaNaH:BvAxiH><level:1>
apahqwavAn	apahqwavaw<vargaH:nA><lifgam:puM><viBakwiH:1><vacanam:1><level:1>
apamAnanam	apamAnana<vargaH:nA><lifgam:puM><viBakwiH:2><vacanam:1><level:1>
apamAnayawaH	apa_mana1<prayogaH:karwari><lakAraH:lat><puruRaH:pra><vacanam:2><paxI:parasmEpaxI><XAwuH:mana><gaNaH:curAxiH><level:1>
apamAnayawi	apa_mAna_Nic<prayogaH:karwari><lakAraH:lat><puruRaH:pra><vacanam:1><paxI:parasmEpaxI><XAwuH:mAna><gaNaH:curAxiH><level:1>
apanamawu	apa_nam1<prayogaH:karwari><lakAraH:lot><puruRaH:pra><vacanam:1><paxI:parasmEpaxI><XAwuH:Nam><gaNaH:BvAxiH><leve:0>
apAwayan	paw1_Nic<prayogaH:karwari><lakAraH:laf><puruRaH:pra><vacanam:3><paxI:parasmEpaxI><XAwuH:pawL><gaNaH:BvAxiH><level:1>
Apawiwa	A_paw1<lifgam:puM><kqw_prawyayaH:kwa><XAwuH:pwL><gaNaH:BvAxiH><level:0>
ApawiwA	ApawiwA<vargaH:nA><lifgam:swrI><viBakwiH:1><vacanam:1><level:1>
apekRaH	apekRaH<vargaH:nA><lifgam:puM><viBakwiH:1><vacanam:1>
AraBawe	Af_raB1<prayogaH:karwari><lakAraH:lat><puruRaH:pra><vacanam:1><paxI:AwmanepaxI><XAwuH:raBaz><gaNaH:BvAxiH>
AraBe	Af_raB1<prayogaH:karwari><lakAraH:lat><puruRaH:u><vacanam:1><paxI:AwmanepaxI><XAwuH:raBa><gaNaH:BvAxiH><level:1>
AraBewAm	Af_raB1<prayogaH:karwari><lakAraH:laf><puruRaH:pra><vacanam:2><paxI:AwmanepaxI><XAwuH:raBa><gaNaH:BvAxiH><level:1>
ArabXavAn	ArabXavaw<vargaH:nA><lifgam:puM><viBakwiH:1><vacanam:1><level:1>
ArakRiNaH	ArakRin<vargaH:nA><lifgam:puM><viBakwiH:1><vacanam:3><level:1>/ArakRin<vargaH:nA><lifgam:puM><viBakwiH:2><vacanam:3><level:1>/ArakRin<vargaH:nA><lifgam:puM><viBakwiH:5><vacanam:1><level:1>/ArakRin<vargaH:nA><lifgam:puM><viBakwiH:6><vacanam:1><level:1>/ArakRin<vargaH:nA><lifgam:puM><viBakwiH:6><vacanam:3><level:1>
arhAH	arha<vargaH:nA><lifgam:puM><viBakwiH:1><vacanam:3><level:1>
ArakRisWAne	ArakRisWAna<vargaH:nA><lifgam:napuM><viBakwiH:1><vacanam:1><level:1>
ArAXyaM	ArAXya<vargaH:nA><lifgam:puM><viBakwiH:2><vacanam:1><level:1>
AroDum	Af_ruh1<vargaH:avy><kqw_prawyayaH:wumun><XAwuH:A_ruh><gaNaH:BvAxiH>
AroDum	Af_ruh1<vargaH:avy><kqw_prawyayaH:wumun><XAwuH:ruh><gaNaH:BvAxiH>
Aroha	Af_ruh1<prayogaH:karwari><lakAraH:lot><puruRaH:ma><vacanam:1><paxI:parasmEpaxI><XAwuH:ruha><gaNaH:BvAxiH><level:1>
Arohan	Af_ruh1<prayogaH:karwari><lakAraH:laf><puruRaH:pra><vacanam:3><paxI:parasmEpaxI><XAwuH:ruha><gaNaH:BvAxiH><level:1>
Arohanwi	Af_ruh1<prayogaH:karwari><lakAraH:lat><puruRaH:pra><vacanam:3><paxI:parasmEpaxI><XAwuH:ruha><gaNaH:BvAxiH><level:1>
ArohanwIm	ArohanwI<vargaH:nA><lifgam:swrI><viBakwiH:2><vacanam:1><level:1>
Arohawi	Af_ruh1<prayogaH:karwari><lakAraH:lat><puruRaH:pra><vacanam:1><paxI:parasmEpaxI><XAwuH:ruha><gaNaH:BvAxiH><level:1>
arpayiwum	q1_Nic<vargaH:avy><kqw_prawyayaH:wumun><XAwuH:q><gaNaH:BvAxiH><level:0>
arpayiwum	q1_Nic<vargaH:avy><kqw_prawyayaH:wumun><XAwuH:q><gaNaH:BvAxiH><level:0>$
aRtaXA	aRtaXA<vargaH:avy><level:1>
Aruroha	Af_ruh<prayogaH:karwari><lakAraH:lit><puruRaH:pra><vacanam:1><paxI:parasmEpaxI><XAwuH:ruh><gaNaH:wuxAxiH><level:0>
arWaM	arWa<vargaH:nA><lifgam:napuM><viBakwiH:1><vacanam:1><level:1>
aSaMsaw	SaMs1<prayogaH:karwari><lakAraH:laf><puruRaH:pra><vacanam:1><paxI:parasmEpaxI><XAwuH:SaMsuz><gaNaH:BvAxiH><level:0>
asaMskqwajFAH	asaMskqwajFa<vargaH:nA><lifgam:puM><viBakwiH:1><vacanam:3><level:1>
asaPalam	asaPala<vargaH:nA><lifgam:napuM><viBakwiH:1><vacanam:1><level:1>
AsasAxa	Af_sax1<prayogaH:karwari><lakAraH:lit><puruRaH:pra><vacanam:1><paxI:parasmEpaxI><XAwuH:Saxlri><gaNaH:wuxAxiH><level:0>
ASAwIwam	ASAwIwa<vargaH:nA><lifgam:napuM><viBakwiH:1><vacanam:1><level:1>
Asaxaw	sax1<prayogaH:karwari><lakAraH:lqf><puruRaH:pra><vacanam:1><paxI:parasmEpaxI><XAwuH:SaxL><gaNaH:BvAxiH><level:0>
aSiRtaM	aSiRta<vargaH:nA><lifgam:puM><viBakwiH:2><vacanam:1><level:1>
ASrayew	Af_Sri1<prayogaH:karwari><lakAraH:viXilif><puruRaH:pra><vacanam:1><paxI:parasmEpaxI><XAwuH:SriF><gaNaH:BvAxiH>
asUyawi	asUya_nAma<prayogaH:karwari><lakAraH:lat><puruRaH:pra><vacanam:1><paxI:parasmEpaxI><XAwuH:asUya><gaNaH:nAma><level:0>
ASvAsayAmAsa	Af_Svas1_Nic<prayogaH:karwari><lakAraH:lit><puruRaH:pra><vacanam:1><paxI:parasmEpaxI><XAwuH:Svasaz><gaNaH:axAxiH>
ASvAsayaw	Af_Svi1_Nic<prayogaH:karwari><lakAraH:laf><puruRaH:pra><vacanam:1><paxI:parasmEpaxI><XAwuH:tuOSvi><gaNaH:BvAxiH><level:1>
aswafgamiwamahimA	aswafgamiwamahiman<vargaH:nA><lifgam:puM><viBakwiH:1><vacanam:1><level:1>
avacinowi	ava_ci1<prayogaH:karwari><lakAraH:lat><puruRaH:pra><vacanam:1><paxI:parasmEpaxI><XAwuH:ciF><gaNaH:wanAxiH><level:1>
avahAsArWam	avahAsArWa<vargaH:nA><lifgam:napuM><viBakwiH:1><vacanam:1>
avajAnanwi	ava_jFA2<prayogaH:karwari><lakAraH:lat><puruRaH:pra><vacanam:3><paxI:parasmEpaxI><XAwuH:jFA><gaNaH:kryAxiH>
avalokayan	ava_lok2<kqw_prawyayaH:Sawq_lat><XAwuH:lokqz><gaNaH:curAxiH><lifgam:puM><viBakwiH:1><vacanam:1>
avanamayya	ava_nam1<vargaH:avy><kqw_prawyayaH:lyap><XAwuH:ava_nam><gaNaH:BvAxiH><level:0>$
avanamayya	ava_nam1<vargaH:avy><kqw_prawyayaH:lyap><XAwuH:_nam><gaNaH:BvAxiH><level:0>
avarNanIyA	avarNanIyA<vargaH:nA><lifgam:swrI><viBakwiH:1><vacanam:1><level:1>
avasAxayew	ava_sax1_Nic<prayogaH:karwari><lakAraH:viXilif><puruRaH:pra><vacanam:1><paxI:parasmEpaxI><XAwuH:RaxLz><gaNaH:BvAxiH>
AvAsinaH	AvAsin<vargaH:nA><lifgam:puM><viBakwiH:1><vacanam:3><level:1>/AvAsin<vargaH:nA><lifgam:puM><viBakwiH:2><vacanam:3><level:1>/AvAsin<vargaH:nA><lifgam:puM><viBakwiH:5><vacanam:1><level:1>/AvAsin<vargaH:nA><lifgam:puM><viBakwiH:6><vacanam:1><level:1>/AvAsin<vargaH:nA><lifgam:puM><viBakwiH:6><vacanam:3><level:1>
avocan	vac1<prayogaH:karwari><lakAraH:laf><puruRaH:pra><vacanam:3><paxi:uBayapaxI><XAwuH:bQF><gaNaH:axAxiH><level:1>
AwafkakArI	AwafkakArin<vargaH:nA><lifgam:puM><viBakwiH:1><vacanam:1><level:1>
awaH	awaH<vargaH:avy><level:1>
awiricyawe	awi_ric1<prayogaH:karmaNi><lakAraH:lat><puruRaH:pra><vacanam:1><paxI:AwmanepaxI><XAwuH:ricizr><gaNaH:ruXAxiH>
AwIwAm	awIwa<vargaH:nA><lifgam:swrI><viBakwiH:2><vacanam:1><level:1>
AwmavivAxAya	AwmavivAxa<vargaH:nA><lifgam:puM><viBakwiH:4><vacanam:1><level:1>
awyAcaranwi	awi_Af_car1<prayogaH:karwari><lakAraH:lat><puruRaH:pra><vacanam:3><paxI:parasmEpaxI><XAwuH:cara><gaNaH:BvAxiH><level:1>
awyaXikam	awyaXika<vargaH:nA><lifgam:napuM><viBakwiH:1><vacanam:1><level:1>
awyucCriwam	awyucCriwa<vargaH:nA><lifgam:napuM><viBakwiH:2><vacanam:1>
aXaHSAKam	aXaHSAKa<vargaH:nA><lifgam:puM><viBakwiH:2><vacanam:1>
AXawsva	Af_XA1<prayogaH:karwari><lakAraH:lot><puruRaH:ma><vacanam:1><paxI:AwmanepaxI><XAwuH:duXAF><gaNaH:juhowyAxiH>
AxaxawI	AxaxawI<vargaH:nA><lifgam:swrI><viBakwiH:1><vacanam:1><level:1>
AXAya	Af_XA1<vargaH:avy><kqw_prawyayaH:lyap><XAwuH:duXAF><gaNaH:juhowyAxiH>
aXigrahIwum	aXi_grah1<vargaH:avy><kqw_prawyayaH:wumun><XAwuH:graha><gaNaH:krayAxiH>
AxiRtavAn	AxiRtavaw<vargaH:nA><lifgam:puM><viBakwiH:1><vacanam:1><level:1>
aXivApsIH	aXi_vAs1_Nic<prayogaH:karwari><lakAraH:lot><puruRaH:maXya><vacanam:1><paxI:parasmEpaxI><XAwuH:vAs><gaNaH:BvAxiH><level:0>
axqSyamanaH	axqSyaman<vargaH:nA><lifgam:puM><viBakwiH:1><vacanam:1><level:1>
axqSyamAnaH	axqSyamAn<vargaH:nA><lifgam:puM><viBakwiH:1><vacanam:1><level:1>
Axriyawe	Af_xq1<prayogaH:karmaNi><lakAraH:lat><puruRaH:pra><vacanam:1><paxI:parasmEpaxI><XAwuH:NIF><gaNaH:svAxiH><level:0>
aXyURuRaH	aXyURuR<vargaH:nA><lifgam:puM><viBakwiH:6><vacanam:1><level:1>
Ayojayaw	Af_yuj2<prayogaH:karwari><lakAraH:laf><puruRaH:pra><vacanam:1><paxI:parasmEpaxI><XAwuH:yuja><gaNaH:curAxiH><level:1>
Ayojayiwum	Af_yuj1<vargaH:avy><kqw_prawyayaH:wumun><XAwuH:yuja><gaNaH:curAxiH>
Ayojayiwum	A_yuj1<vargaH:avy><kqw_prawyayaH:wumun><XAwuH:yuja><gaNaH:curAxiH>
AyojiwavAn	Ayojiwavaw<vargaH:nA><lifgam:puM><viBakwiH:1><vacanam:1><level:1>
Ayojya	Af_yuj1_Nic<vargaH:avy><kqw_prawyayaH:lyap><XAwuH:yujaz><gaNaH:xivAxiH><level:0>/Af_yuj1_Nic<vargaH:avy><kqw_prawyayaH:lyap><XAwuH:yujir><gaNaH:ruXAxiH><level:0>/Af_yuj1_Nic<vargaH:avy><kqw_prawyayaH:lyap><XAwuH:yujaz><gaNaH:curAxiH><level:0>
Ayojya	A_yuj1<vargaH:avy><kqw_prawyayaH:lyap><XAwuH:A_yuja><gaNaH:curAxiH><level:0>$
AyuRmanwam	AyuRmat<vargaH:nA><lifgam:puM><viBakwiH:2><vacanam:1><level:1>
bahusamayaparyanwam	bahusamayaparyanwa<vargaH:nA><lifgam:napuM><viBakwiH:1><vacanam:1><level:1>
BakRiwavAn	BakRiwavaw<vargaH:nA><lifgam:puM><viBakwiH:1><vacanam:1><level:1>
bAlagafgAXaram	bAlagafgaXara<vargaH:nA><lifgam:puM><viBakwiH:2><vacanam:1><level:1>
bAlagafgAXarawilake	bAlagafgaXarawilaka<vargaH:nA><lifgam:puM><viBakwiH:7><vacanam:1><level:1>
bAlagafgAXare	bAlagafgaXara<vargaH:nA><lifgam:puM><viBakwiH:7><vacanam:1><level:1>
BaRamANAn	BaR1<kqw_prawyayaH:SAnac><XAwuH:BaRaz><gaNaH:BvAxiH><lifgam:puM><viBakwiH:2><vacanam:3>
BaRanwam	BaRaw<vargaH:nA><lifgam:puM><viBakwiH:2><vacanam:1><level:1>
BArawamAwA	BArawamAwA<vargaH:nA><lifgam:swrI><viBakwiH:1><vacanam:1><level:1>
BArawIyaH	BArawIya<vargaH:nA><lifgam:puM><viBakwiH:1><vacanam:1><level:1>
BArawIyAH	BArawIya<vargaH:nA><lifgam:puM><viBakwiH:1><vacanam:3><level:1>
BArawIyaM	BArawIya<vargaH:nA><lifgam:puM><viBakwiH:2><vacanam:1><level:1>
Barwsayan	Barwsayaw<vargaH:nA><lifgam:puM><viBakwiH:1><vacanam:1><level:1>
BaxraveRAm	BaxraveRA<vargaH:nA><lifgam:swrI><viBakwiH:2><vacanam:1><level:1>
baxXvA	baX1<vargaH:avy><kqw_prawyayaH:kwvA><XAwuH:banX><gaNaH:BvAxiH><level:0>
bhojayiRyAmi	Buj1_Nic<prayogaH:karwari><lakAraH:lrit><puruRaH:u><vacanam:1><paxI:parasmEpaxI><XAwuH:Buj><gaNaH:ruXAxiH><level:1>
biByawIm	biByat<vargaH:nA><lifgam:napum><viBakwiH:1><vacanam:1><level:1>
BIRmapiwAmahaH	BIRmapiwAmaha<vargaH:nA><lifgam:puM><viBakwiH:1><vacanam:1><level:1>
BIRmapiwAmahaM	BIRmapiwAmaha<vargaH:nA><lifgam:puM><viBakwiH:2><vacanam:1><level:1>
BIRmapiwAmahasya	BIRmapiwAmaha<vargaH:nA><lifgam:puM><viBakwiH:6><vacanam:1><level:1>
BIRmapiwAmahAya	BIRmapiwAmaha<vargaH:nA><lifgam:puM><viBakwiH:4><vacanam:1><level:1>
BIRmapiwAmahena	BIRmapiwAmaha<vargaH:nA><lifgam:puM><viBakwiH:3><vacanam:1><level:1>
BojanAlayaH	BojanAlaya<vargaH:nA><lifgam:puM><viBakwiH:1><vacanam:1><level:1>
BojayanwaH	Bojayaw<vargaH:nA><lifgam:puM><viBakwiH:1><vacanam:3><level:1>
BojayiRyAmi	Buj1_Nic<prayogaH:karwari><lakAraH:lqt><puruRaH:u><vacanam:1><paxI:parasmEpaxI><XAwuH:Buja><gaNaH:ruXAxiH><level:1>
BojiwavAn	Bojiwavaw<vargaH:nA><lifgam:puM><viBakwiH:1><vacanam:1><level:1>
boXayanwaH	buX2_Nic<kqw_prawyayaH:kwa><XAwuH:buXizr><gaNaH:BvAxiH><lifgam:puM><viBakwiH:1><vacanam:3>
BrAmayan	Bram2_Nic<kqw_prawyayaH:Sawq_lat><XAwuH:Bramuz><gaNaH:xivAxiH><lifgam:puM><viBakwiH:1><vacanam:1>
BrAmayiwum	Bram1<vargaH:avy><kqw_prawyayaH:wumun><XAwuH:Bramu><gaNaH:xivAxiH>
BuFjAnAH	BuFjAna<vargaH:nA><lifgam:puM><viBakwiH:1><vacanam:3><level:1>
BuFjAnam	Buj2<kqw_prawyayaH:Sawq_lat><XAwuH:Bujaz><gaNaH:ruXAxiH><lifgam:puM><viBakwiH:2><vacanam:1>
BukkuNdaH	BukkuNda<vargaH:nA><lifgam:puM><viBakwiH:1><vacanam:1><level:1>
buxXvA	buX1<vargaH:avy><kqw_prawyayaH:kwvA><XAwuH:buXir><ganaH:BvAxiH>
cAkagulikA	cAkagulikA<vargaH:nA><lifgam:swrI><viBakwiH:1><vacanam:1><level:1>
cAkagulikAH	cAkagulikA<vargaH:nA><lifgam:swrI><viBakwiH:1><vacanam:3><level:1>/cAkagulikA<vargaH:nA><lifgam:swrI><viBakwiH:2><vacanam:3><level:1>
cAkagulikayA	cAkagulikA<vargaH:nA><lifgam:swrI><viBakwiH:3><vacanam:1><level:1>
CalayawAm	Calayaw<vargaH:nA><lifgam:napuM><viBakwiH:6><vacanam:3>
camU	camU<vargaH:nA><lifgam:swrI><viBakwiH:1><vacanam:1><level:1>
cAriwrikIm	cAriwrikI<vargaH:nA><lifgam:swrI><viBakwiH:2><vacanam:1><level:1>
CAwrAvAse	CAwrAvAsa<vargaH:nA><lifgam:puM><viBakwiH:7><vacanam:1><level:1>
cEva	cEva<vargaH:avy><level:1>
cikiwsAlayaH	cikiwsAlaya<vargaH:nA><lifgam:puM><viBakwiH:1><vacanam:1><level:1>
cikiwsAlayam	cikiwsAlaya<vargaH:nA><lifgam:puM><viBakwiH:2><vacanam:1><level:1>
cikiwsAlayasya	cikiwsAlaya<vargaH:nA><lifgam:puM><viBakwiH:6><vacanam:1><level:1>
cikiwsAlayAw	cikiwsAlaya<vargaH:nA><lifgam:puM><viBakwiH:5><vacanam:1><level:1>
cikiwsAlaye	cikiwsAlaya<vargaH:nA><lifgam:puM><viBakwiH:7><vacanam:1><level:1>
citikA	citikA<vargaH:nA><lifgam:swrI><viBakwiH:1><vacanam:1><level:1>
citikAm	citikA<vargaH:nA><lifgam:swrI><viBakwiH:2><vacanam:1><level:1>
citikAyAH	citikA<vargaH:nA><lifgam:swrI><viBakwiH:6><vacanam:1><level:1>
cIwkarowi	cIw_kq3<prayogaH:karwari><lakAraH:lat><puruRaH:pra><vacanam:1><paxI:parasmEpaxI><XAwuH:cIw_dukqF><gaNaH:wanAxiH><level:0>
ciwramanxiram	ciwramanxira<vargaH:nA><lifgam:napuM><viBakwiH:2><vacanam:1><level:1>
ciwwawvam	ciwwawva<vargaH:nA><lifgam:napuM><viBakwiH:1><vacanam:1>
cyavanwi	cyu1<prayogaH:karwari><lakAraH:lat><puruRaH:pra><vacanam:3><paxI:parasmEpaxI><XAwuH:cyuf><gaNaH:BvAxiH>
darSayan	darSayaw<vargaH:nA><lifgam:puM><viBakwiH:1><vacanam:1><level:1>
eke	eka<vargaH:nA><lifgam:puM><viBakwiH:1><vacanam:3>
GaniRTaM	GaniRTa<vargaH:nA><lifgam:napuM><viBakwiH:1><vacanam:1><level:1>
ganwavyasWalam	ganwavyasWala<vargaH:nA><lifgam:napuM><viBakwiH:1><vacanam:1><level:1>
gAnXI	gAnXI<vargaH:nA><lifgam:puM><viBakwiH:1><vacanam:1><level:1>
garvase	garv1<prayogaH:karwari><lakAraH:lat><puruRaH:ma><vacanam:1><paxI:parasmEpaxI><XAwuH:><gaNaH:BvAxiH><level:1>
gAyamAnO	gAyamAna<vargaH:nA><lifgam:puM><viBakwiH:1><vacanam:2><level:1>
girijAgqham	girijAgqha<vargaH:nA><lifgam:napuM><viBakwiH:2><vacanam:1><level:1>
gopyaM	gopya<vargaH:nA><lifgam:napuM><viBakwiH:1><vacanam:1><level:1>
gOwamabuxXaH	gOwamabuxXa<vargaH:nA><lifgam:puM><viBakwiH:1><vacanam:1><level:1>
gOwamabuxXam	gOwamabuxXa<vargaH:nA><lifgam:puM><viBakwiH:2><vacanam:1><level:1>
gOwamabuxXAya	gOwamabuxXa<vargaH:nA><lifgam:puM><viBakwiH:4><vacanam:1><level:1>
gqhiNaH	hqhin<vargaH:nA><lifgam:puM><viBakwiH:1><vacanam:3><level:1>
gqhIwvA	gqh1<vargaH:avy><kqw_prawyayaH:kwvA><XAwuH:gqhU><gaNaH:BvAxiH><level:0>
grIRmarwoH	grIRmarwu<vargaH:nA><lifgam:puM><viBakwiH:6><vacanam:1><level:1>
harIwimA	harIwimA<vargaH:nA><lifgam:swrI><viBakwiH:1><vacanam:1><level:1>
harRapUrvakam	harRapUrvaka<vargaH:nA><lifgam:napuM><viBakwiH:2><vacanam:1><level:1>
haswaleKanam	haswaleKana<vargaH:nA><lifgam:napuM><viBakwiH:2><vacanam:1><level:1>
ipsunA	ipsu<vargaH:nA><lifgam:puM><viBakwiH:3><vacanam:1>
IsAmasIham	IsAmasIha<vargaH:nA><lifgam:puM><viBakwiH:2><vacanam:1><level:1>
ISvaracanxravixyAsAgaraH	ISvaracanxravixyAsAgara<vargaH:nA><lifgam:puM><viBakwiH:1><vacanam:1><level:1>
ISvaracanxravixyAsAgarAya	ISvaracanxravixyAsAgara<vargaH:nA><lifgam:puM><viBakwiH:4><vacanam:1><level:1>
iyAn	iyaw<vargaH:nA><lifgam:puM><viBakwiH:1><vacanam:1><level:1>
jAgarayanwI	jAgq1_Nic<prayogaH:karwari><lakAraH:lat><puruRaH:pra><vacanam:3><paxI:parasmEpaxI><XAwuH:jAgq><gaNaH:juhowyAxiH><level:1>/jAgarayanwI<vargaH:nA><lifgam:swrI><viBakwiH:1><vacanam:1><level:1>
jAjvalyamAnA	jAjvalyamAnA<vargaH:nA><lifgam:swrI><viBakwiH:1><vacanam:1><level:1>
jalaSAlAm	jalaSAlA<vargaH:nA><lifgam:swrI><viBakwiH:2><vacanam:1><level:1>
janakawanayAsnAnapuNyoxakeRu	janakawanayAsnAnapuNyoxaka<vargaH:nA><lifgam:puM><viBakwiH:7><vacanam:3><level:1>
janwuSAlAm	janwuSAlA<vargaH:nA><lifgam:swrI><viBakwiH:2><vacanam:1><level:1>
jatAyuRam	jatAyus<vargaH:nA><lifgam:puM><viBakwiH:2><vacanam:1><level:1>
jAwIyA	jAwIyA<vargaH:nA><lifgam:swrI><viBakwiH:1><vacanam:1><level:1>
jijFAsawe	jFA1_san<prayogaH:karwari><lakAraH:lat><puruRaH:pra><vacanam:1><paxI:parasmEpaxI><XAwuH:sam_jan><gaNaH:kryAxiH><level:1>
jijFAsiwavAn	jijFAsiwavaw<vargaH:nA><lifgam:puM><viBakwiH:1><vacanam:1><level:1>
jijIviRAmaH	jIv1_san<prayogaH:karwari><lakAraH:lat><puruRaH:u><vacanam:3><paxI:parasmEpaxI><XAwuH:jIvaz><gaNaH:BvAxiH>
jIvanawaH	jIvanawa<vargaH:nA><lifgam:puM><viBakwiH:1><vacanam:1><level:1>
jIvanayAwrAyAH	jIvanayAwrA<vargaH:nA><lifgam:swrI><viBakwiH:6><vacanam:1><level:1>
jIvAwmA	jIvAwman<vargaH:nA><lifgam:puM><viBakwiH:1><vacanam:1><level:1>
jIvAwmanaH	jIvAwman<vargaH:nA><lifgam:puM><viBakwiH:2><vacanam:3><level:1>/jIvAwman<vargaH:nA><lifgam:puM><viBakwiH:5><vacanam:1><level:1>/jIvAwman<vargaH:nA><lifgam:puM><viBakwiH:6><vacanam:1><level:1>
kanakavalayaBraMSarikwaprakoRTaH	kanakavalayaBraMSarikwaprakoRTa<vargaH:nA><lifgam:puM><viBakwiH:1><vacanam:1><level:1>
kAnwAvirahaguruNA	kAnwAvirahaguru<vargaH:nA><lifgam:puM><viBakwiH:3><vacanam:1><level:1>
kArayAnena	kArayAna<vargaH:nA><lifgam:napuM><viBakwiH:1><vacanam:1><level:1>
kArayan	kq3_Nic<kqw_prawyayaH:Sawq_lat><XAwuH:dukqF><gaNaH:wanAxiH><lifgam:puM><viBakwiH:1><vacanam:1>
kArayanwaH	kArayaw<vargaH:nA><lifgam:puM><viBakwiH:1><vacanam:3><level:1>
kArayiwum	kq1_Nic<vargaH:avy><kqw_prawyayaH:wumun><XAwuH:dukqF><gaNaH:wanAxiH>
kArayiwvA	kri1_Nic<vargaH:avy><kqw_prawyayaH:kwvA><XAwuH:dukrIF><gaNaH:wanAxiH><level:0>
kAriwavAn	kAriwavaw<vargaH:nA><lifgam:puM><viBakwiH:1><vacanam:1><level:1>
kAriwavawI	kAriwavawI<vargaH:nA><lifgam:swrI><viBakwiH:1><vacanam:1><level:1>
karmacArI	karmacArin<vargaH:nA><lifgam:puM><viBakwiH:1><vacanam:1><level:1>
karmacAriNaH	karmacArin<vargaH:nA><lifgam:puM><viBakwiH:1><vacanam:3><level:1>/karmacArin<vargaH:nA><lifgam:puM><viBakwiH:2><vacanam:3><level:1>/karmacArin<vargaH:nA><lifgam:puM><viBakwiH:5><vacanam:1><level:1>/karmacArin<vargaH:nA><lifgam:puM><viBakwiH:6><vacanam:1><level:1>
karmacAriNI	karmcAriNI<vargaH:nA><lifgam:swrI><viBakwiH:1><vacanam:1><level:1>
kawaraw	kawaraw<vargaH:nA><lifgam:napuM><viBakwiH:1><vacanam:1>
kaWayanwaH	kaWayan<vargaH:nA><lifgam:puM><viBakwiH:1><vacanam:3><level:1>
kaWayawaH	kaWa1<kqw_prawyayaH:Sawq_lat><XAwuH:kaWa><gaNaH:curAxiH><lifgam:puM><viBakwiH:5><vacanam:1>
KAxayanwaH	KAxayaw<vargaH:nA><lifgam:puM><viBakwiH:1><vacanam:3><level:1>
kEkeyyI	kEkeyyI<vargaH:nA><lifgam:swrI><viBakwiH:1><vacanam:1><level:1>
keSavaSAswrI	keSavaSAswrin<vargaH:nA><lifgam:puM><viBakwiH:1><vacanam:1><level:1>
keSavaSAswriNaH	keSavaSAswrin<vargaH:nA><lifgam:puM><viBakwiH:1><vacanam:3><level:1>
keSavaSAswriNam	keSavaSAswrin<vargaH:nA><lifgam:puM><viBakwiH:2><vacanam:1><level:1>
kilbiRaH	kilbiRa<vargaH:nA><lifgam:puM><viBakwiH:1><vacanam:1>
kiMvA	kiMvA<vargaH:avy><level:1>
kqwavanwAn	kqwavaw<vargaH:nA><lifgam:puM><viBakwiH:1><vacanam:3><level:1>
krAWayawi	kraW1_Nic<prayogaH:karwari><lakAraH:lat><puruRaH:pra><vacanam:1><paxI:parasmEpaxI><XAwuH:vixa><gaNaH:BvAxiH><level:0>
kRewragAminA	kRewragAmin<vargaH:nA><lifgam:puM><viBakwiH:3><vacanam:1><level:1>
kriketaKelaH	kriketaKela<vargaH:nA><lifgam:puM><viBakwiH:1><vacanam:1><level:1
kriketam	kriketa<vargaH:nA><lifgam:napuM><viBakwiH:2><vacanam:1><level:1>
kRuwpipAsayA	kRuwpipAsA<vargaH:nA><lifgam:swrI><viBakwiH:3><vacanam:1><level:1>
kulaxIpakaH	kulaxIpaka<vargaH:nA><lifgam:puM><viBakwiH:1><vacanam:1><level:1>
laBew	laB1<prayogaH:karwari><lakAraH:viXilif><puruRaH:pra><vacanam:1><paxI:parasmEpaxI><XAwuH:dulaBazR><gaNaH:BvAxiH>
leKayiwum	liK1_Nic<vargaH:avy><kqw_prawyayaH:wumun><XAwuH:liKa><gaNaH:wuxAxiH>
leKayiwvA	liK1_Nic<vargaH:avy><kqw_prawyayaH:kwvA><XAwuH:liKa><gaNaH:wuxAxiH><level:0>
lElA	lElA<vargaH:nA><lifgam:swrI><viBakwiH:1><vacanam:1><level:1>
lokamAnyabAlagafgAXarawilake	lokamAnyabAlagafgaXarawilaka<vargaH:nA><lifgam:puM><viBakwiH:7><vacanam:1><level:1>
lolupwvam	lolupwva<vargaH:nA><lifgam:napuM><viBakwiH:1><vacanam:1>
mafkRyawi	masj1<prayogaH:karwari><lakAraH:lqt><puruRaH:pra><vacanam:1><paxI:parasmEpaxI><XAwuH:tumasjo><gaNaH:wuxAxiH><level:1>
mahAsAgaraH	mahAsAgara<vargaH:nA><lifgam:puM><viBakwiH:1><vacanam:1><level:1>
majjanwi	masj1<prayogaH:karwari><lakAraH:lat><puruRaH:pra><vacanam:1><paxI:parasmEpaxI><XAwuH:tumasjoz><gaNaH:wuxAxiH><level:0>
majjawi	masja<prayogaH:karwari><lakAraH:lat><puruRaH:pra><vacanam:1><paxI:parasmEpaxI><XAwuH:masja><gaNaH:wuxAxiH><level:1>
mamaH	mama<vargaH:nA><lifgam:puM><viBakwiH:1><vacanam:1>
manaHsWiwiH	manaHsWiwi<vargaH:nA><lifgam:swrI><viBakwiH:1><vacanam:1><level:1>
mAnasarovaram	mAnasarovara<vargaH:nA><lifgam:napuM><viBakwiH:2><vacanam:1><level:1>
manmayAH	manmaya<vargaH:nA><lifgam:puM><viBakwiH:1><vacanam:3>
manxawAM	manxawA<vargaH:nA><lifgam:swrI><viBakwiH:2><vacanam:1><level:1>
mArayiwum	mq1_Nic<vargaH:avy><kqw_prawyayaH:wumun><XAwuH:mqf><gaNaH:wuxAxiH>
mArayiwvA	mq1_Nic<vargaH:avy><kqw_prawyayaH:kwvA><XAwuH:mq><gaNaH:wuxAxiH><level:0>
mArgamANaH	mArgamANa<kqw_prawyayaH:Sawq_lat><XAwuH:mArg><gaNaH:curAxiH><level:0><kqw_pratipadika:mArgamANa><vargaH:nA><lifgam:puM><viBakwiH:1><vacanam:1>
mArgiNaH	mArgin<vargaH:nA><lifgam:puM><viBakwiH:1><vacanam:3><level:1>
masjixam	masjixa<vargaH:nA><lifgam:napuM><viBakwiH:2><vacanam:1><level:1>
mawgawena	asmax-gawa<vargaH:nA><lifgam:puM><viBakwiH:3><vacanam:1>
mAxqSAH	mAxqSa<vargaH:nA><lifgam:puM><viBakwiH:1><vacanam:3><level:1>
maXyeyAwram	maXyeyAwra<vargaH:nA><lifgam:napuM><viBakwiH:1><vacanam:1><level:1>
miRtAnnaM	miRtAnna<vargaH:nA><lifgam:napuM><viBakwiH:1><vacanam:1><level:1>
miRtAnnAni	miRtAnna<vargaH:nA><lifgam:napuM><viBakwiH:1><vacanam:3><level:1>/miRtAnna<vargaH:nA><lifgam:napuM><viBakwiH:2><vacanam:3><level:1>
miRtAnnavyavasAyI	miRtAnnavyavasAyin<vargaH:nA><lifgam:puM><viBakwiH:1><vacanam:1><level:1>
miRtAnnavyavasAyinoH	miRtAnnavyavasAyin<vargaH:nA><lifgam:puM><viBakwiH:5><vacanam:2><level:1>/miRtAnnavyavasAyin<vargaH:nA><lifgam:puM><viBakwiH:6><vacanam:2><level:1>
mqNmaye	mqNmaya<vargaH:nA><lifgam:napuM><viBakwiH:7><vacanam:1><level:1>
muhyanwi	muh1<prayogaH:karwari><lakAraH:lat><puruRaH:pra><vacanam:3><paxI:parasmEpaxI><XAwuH:muhaz><gaNaH:xivAxiH>
muhyawi	muh1<prayogaH:karwari><lakAraH:lat><puruRaH:pra><vacanam:1><paxI:parasmEpaxI><XAwuH:muha><gaNaH:xivAxiH><level:1>
mUrXni	mUrXna<vargaH:nA><lifgam:napuM><viBakwiH:7><vacanam:1>
nAmaxevaH	nAmaxeva<vargaH:nA><lifgam:puM><viBakwiH:1><vacanam:1><level:1>
nayew	nI1<prayogaH:karwari><lakAraH:viXilif><puruRaH:pra><vacanam:1><paxI:AwmanepaxI><XAwuH:NIF><gaNaH:BvAxiH>
neharO	neharu<vargaH:nA><lifgam:puM><viBakwiH:7><vacanam:1><level:1>
neharuH	neharu<vargaH:nA><lifgam:puM><viBakwiH:1><vacanam:1><level:1>
neharum	neharu<vargaH:nA><lifgam:puM><viBakwiH:2><vacanam:1><level:1>
nERkqwikaH	nERkqwika<vargaH:nA><lifgam:puM><viBakwiH:1><vacanam:1>
nigrAhayiRyAmi	ni_grah1_Nic<prayogaH:karwari><lakAraH:lrit><puruRaH:u><vacanam:1><paxI:parasmEpaxI><XAwuH:graha><gaNaH:kryAxiH><level:1>
niHsaran	niHsaraw<vargaH:nA><lifgam:napuM><viBakwiH:1><vacanam:1><level:1>
niHsArayawu	niH_sru1_Nic<prayogaH:karwari><lakAraH:lot><puruRaH:pra><vacanam:1><paxI:parasmEpaxI><XAwuH:sru><gaNaH:BvAxiH><level:1>
niHsArayiwum	nis_sq1_Nic<vargaH:avy><kqw_prawyayaH:wumun><XAwuH:sq><gaNaH:BvAxiH>
niHSulkam	niHSulka<vargaH:nA><lifgam:napuM><viBakwiH:1><vacanam:1><level:1>
niHSvasanwam	niHSvasaw<vargaH:nA><lifgam:puM><viBakwiH:2><vacanam:1><level:1>
nimanwriwavAn	nimanwriwavaw<vargaH:nA><lifgam:puM><viBakwiH:1><vacanam:1><level:1>
nipAwayawi	ni_paw1_Nic<prayogaH:karwari><lakAraH:lat><puruRaH:pra><vacanam:1><paxI:parasmEpaxI><XAwuH:paw><gaNaH:BvAdiH><level:1>
nipawiwaH	nipawiwa<vargaH:nA><lifgam:puM><viBakwiH:1><vacanam:1><level:1>
niprahanyuH	ni_pra_han1<prayogaH:karwari><lakAraH:viXilif><puruRaH:pra><vacanam:3><paxI:parasmEpaxI><XAwuH:han><gaNaH:axAxiH><level:0>
niragcCat	nir_gama<prayogaH:karwari><lakAraH:laf><puruRaH:pra><vacanam:1><paxI:parasmEpaxI><XAwuH:gamL><gaNaH:BvAxiH><level:1>
niraparAXinaH	niraparAXin<vargaH:nA><lifgam:puM><viBakwiH:6><vacanam:1><level:1>
niraprAXinaH	niraprAXin<vargaH:nA><lifgam:puM><viBakwiH:1><vacanam:3><level:1>
niReXawi	ni_siX1<prayogaH:karwari><lakAraH:lat><puruRaH:pra><vacanam:1><paxI:parasmEpaxI><XAwuH:RiXu><gaNaH:wanAxiH><level:1>
nirgawaH	nirgawa<vargaH:nA><lifgam:puM><viBakwiH:1><vacanam:1><level:1>
nirgawe	nirgawa<vargaH:nA><lifgam:puM><viBakwiH:7><vacanam:1><level:1>
nirjagAma	nir_gam1<prayogaH:karwari><lakAraH:lit><puruRaH:pra><vacanam:1><paxI:parasmEpaxI><XAwuH:gamL><gaNaH:BvAxiH><level:0>
nirmamaH	nirmama<vargaH:nA><lifgam:puM><viBakwiH:1><vacanam:1>
nirmAmi	nir_mA1<prayogaH:karwari><lakAraH:lat><puruRaH:utTama><vacanam:1><paxI:parasmEpaxI><XAwuH:mA><gaNaH:axAxiH><level:1>
nirmAnwi	nir_mA1<prayogaH:karwari><lakAraH:lat><puruRaH:pra><vacanam:3><paxI:parasmEpaxI><XAwuH:mA><gaNaH:BvAxiH><level:1>
nirmApiwavAn	nirmApiwavaw<vargaH:nA><lifgam:puM><viBakwiH:1><vacanam:1><level:1>
nirmApiwavawI	nirmApiwavawI<vargaH:nA><lifgam:swrI><viBakwiH:1><vacanam:1><level:1>
nirmAsyAmi	nir_mA1<prayogaH:karwari><lakAraH:lrit><puruRaH:u><vacanam:1><paxI:parasmEpaxI><XAwuH:mA><gaNaH:axAxiH><level:1>
nirmAwum	nir_mA1<vargaH:avy><kqw_prawyayaH:wumun><XAwuH:mA><gaNaH:axAxiH>
nirmiwaH	nirmiwa<vargaH:nA><lifgam:puM><viBakwiH:1><vacanam:1><level:1>
nirmiwaM	nirmiwa<vargaH:nA><lifgam:napuM><viBakwiH:1><vacanam:1><level:1>/nirmiwa<vargaH:nA><lifgam:puM><viBakwiH:2><vacanam:1><level:1>
nirNayawi	nir_nI1<prayogaH:karwari><lakAraH:lat><puruRaH:pra><vacanam:1><paxI:parasmEpaxI><XAwuH:NIF><gaNaH:BvAxiH><level:0>
niroDya	ni_ruD1<vargaH:avy><kqw_prawyayaH:lyap><XAwuH:ruD><gaNaH:xivAxiH><level:0>
niroDya	ni_ruD1<vargaH:avy><kqw_prawyayaH:lyap><XAwuH:ruD><gaNaH:xivAxiH><level:0>$
nirvarwiwavanwO	nir_vqw1<kqw_prawyayaH:kwavawu><XAwuH:vqwuz><gaNaH:BvAxiH><level:0><kqw_pratipadika:nirvarwiwavaw><vargaH:nA><lifgam:puM><viBakwiH:1><vacanam:2>
nirvarwiwum	ni_vqw1<vargaH:avy><kqw_prawyayaH:wumun><XAwuH:vqwu><gaNaH:BvAxiH>
nirvAsayiRyawi	nir_vas4<prayogaH:karwari><lakAraH:lrit><puruRaH:u><vacanam:1><paxI:parasmEpaxI><XAwuH:vasaz><gaNaH:curAxiH><level:1>
nirvAsayiSyawi	nir_vasa1_Nic<prayogaH:karwari><lakAraH:lat><puruRaH:pra><vacanam:1><paxI:parasmEpaxI><XAwuH:vasa><gaNaH:BvAxiH><level:1>
nirvAsayiwum	nir_vasa<vargaH:avy><kqw_prawyayaH:wumun><XAwuH:nir_vasa><gaNaH:BvaxiH><level:0>
nirvAsayiwum	nir_vasa<vargaH:avy><kqw_prawyayaH:wumun><XAwuH:vasa><gaNaH:BvaxiH><level:0>
nirxaSAnanAni	nirxaSanana<vargaH:nA><lifgam:napum><viBakwiH:1><vacanam:3><level:1>
nirxeRtum	nir_xiS1<vargaH:avy><kqw_prawyayaH:wumun><XAwuH:xiSa><gaNaH:wuxAxiH>
niScarawi	ni_car1<prayogaH:karwari><lakAraH:lat><puruRaH:pra><vacanam:1><paxI:parasmEpaxI><XAwuH:caraz><gaNaH:BvAxiH>
nis-spqhaH	spqha<vargaH:nA><lifgam:puM><viBakwiH:1><vacanam:1>
nivArayan	nivArayaw<vargaH:nA><lifgam:puM><viBakwiH:1><vacanam:1><level:1>
nivArayanwI	nivArayanwI<vargaH:nA><lifgam:swrI><viBakwiH:1><vacanam:1><level:1>
nivarwanwe	ni_vqw1<prayogaH:karwari><lakAraH:lat><puruRaH:pra><vacanam:3><paxI:AwmanepaxI><XAwuH:vqwuz><gaNaH:BvAxiH>
nivarwayAmAsa	ni_vqw1<prayogaH:karwari><lakAraH:lit><puruRaH:pra><vacanam:1><paxI:parasmEpaxI><XAwuH:vqwu><gaNaH:BvAxiH><level:0>
nivarwaya	ni_vqw1<prayogaH:karwari><lakAraH:lot><puruRaH:maXya><vacanam:1><paxI:parasmEpaxI><XAwuH:vqwu><gaNaH:BvAxiH><level:0>
nivarwiwum	ni_vqw1<vargaH:avy><kqw_prawyayaH:wumun><XAwuH:vqwuz><gaNaH:BvAxiH>
nivarwwya	ni_vqw1<prayogaH:karwari><lakAraH:lot><puruRaH:maXya><vacanam:1><paxI:parasmEpaxI><XAwuH:vqwu><gaNaH:BvAxiH><level:0>
nivasiRyasi	ni_vas<prayogaH:karwari><lakAraH:lqt><puruRaH:ma><vacanam:1><paxI:parasmEpaxI><XAwuH:vasaz><gaNaH:BvAxiH>
niveSaya	ni_viS1_Nic<prayogaH:karwari><lakAraH:lat><puruRaH:pra><vacanam:1><paxI:parasmEpaxI><XAwuH:viSaz><gaNaH:wuxAxiH>
nivexayAmi	ni_vix3<prayogaH:karwari><lakAraH:lat><puruRaH:u><vacanam:1><paxI:parasmEpaxI><XAwuH:vixa><gaNaH:curAxiH><level:1>
nivexayan	ni_vex1<prayogaH:karwari><lakAraH:laf><puruRaH:pra><vacanam:1><paxI:parasmEpaxI><XAwuH:vexa><gaNaH:curAxiH><level:1>
nivexayawi	ni_vix4<prayogaH:karwari><lakAraH:lat><puruRaH:pra><vacanam:1><paxI:parasmEpaxI><XAwuH:vixa><gaNaH:curAxiH><level:0>
nivexayawu	niH_vix1_Nic<prayogaH:karwari><lakAraH:lot><puruRaH:pra><vacanam:1><paxI:parasmEpaxI><XAwuH:vixL><gaNaH:svAxiH><level:1>
nivexayiRyAmi	ni_vix1<prayogaH:karwari><lakAraH:lqt><puruRaH:u><vacanam:1><paxI:parasEpaxI><XAwuH:IkRa><gaNaH:curAxiH><level:1>
niwyavEriNA	niwyavErin<vargaH:nA><lifgam:napuM><viBakwiH:3><vacanam:1>
nixaXaw	nixaXaw<vargaH:nA><lifgam:napuM><viBakwiH:1><vacanam:1><level:1>
niyanwum	ni_yam1<vargaH:avy><kqw_prawyayaH:wumun><XAwuH:yamu><gaNaH:BvAxiH><level:0>
niyanwum	ni_yam1<vargaH:avy><kqw_prawyayaH:wumun><XAwuH:yamu><gaNaH:BvAxiH><level:0>$
niyojayasi	ni_yuj1<prayogaH:karwari><lakAraH:lat><puruRaH:ma><vacanam:1><paxI:parasmEpaxI><XAwuH:yujaz><gaNaH:curAxiH>/yuj3<prayogaH:karwari><lakAraH:lat><puruRaH:ma><vacanam:eka><paxI:parasmEpaxI><XAwuH:yujaz><gaNaH:curAxiH>
niyokRyanwi	ni_yuj1<prayogaH:karwari><lakAraH:lqt><puruRaH:pra><vacanam:1><paxI:parasmEpaxI><XAwuH:yujaz><gaNaH:xivAxiH><level:0>
niyokRyawi	ni_yuj2<prayogaH:karwari><lakAraH:lqt><puruRaH:pra><vacanam:1><paxI:AwmanepaxI><XAwuH:yujizr><gaNaH:ruXAxiH>
nyapAwayaw	ni_paw1_Nic<prayogaH:karwari><lakAraH:laf><puruRaH:pra><vacanam:1><paxI:parasmEpaxI><XAwuH:pawL><gaNaH:BvAxiH><level:1>
nyaReXIw	ni_siX1<prayogaH:karwari><lakAraH:luf><puruRaH:pra><vacanam:1><paxI:parasmEpaxI><XAwuH:siXu><gaNaH:BvAxiH><level:1>
nyavArayaw	ni_vq2<prayogaH:karwari><lakAraH:laf><puruRaH:pra><vacanam:1><paxI:parasmEpaxI><XAwuH:vq><gaNaH:curAxiH><level:1>
nyavarwawa	ni_vqw1<prayogaH:karwari><lakAraH:laf><puruRaH:pra><vacanam:1><paxI:AwmanEpaxI><XAwuH:vqwu><gaNaH:BvAxiH><level:1>
nyavarwyaw	ni_vruw1<prayogaH:karwari><lakAraH:laf><puruRaH:pra><vacanam:1><paxI:parasmEpaxI><XAwuH:vruwu><gaNaH:curAxiH><level:1>
nyavexayan	ni_vix1<prayogaH:karwari><lakAraH:laf><puruRaH:pra><vacanam:3><paxI:parasmEpaxI><XAwuH:vixa><gaNaH:BvAxiH><level:1>
nyavexayaw	ni_vix1<prayogaH:karwari><lakAraH:laf><puruRaH:pra><vacanam:1><paxI:parasmEpaxI><XAwuH:vixa><gaNaH:BvAxiH><level:1>
nyAyAlayasya	nyAyAlaya<vargaH:nA><lifgam:puM><viBakwiH:6><vacanam:1><level:1>
nyAyAlayawaH	nyAyalaya<vargaH:avy><waxXiwa_prawyayaH:wasil><level:0>
nyAyAlaye	nyAyAlaya<vargaH:nA><lifgam:puM><viBakwiH:7><vacanam:1><level:1>
pAKaNdinam	pAKaNdin<vargaH:nA><lifgam:puM><viBakwiH:2><vacanam:1><level:1>
paramAwmAnaH	paramAwman<vargaH:nA><lifgam:puM><viBakwiH:1><vacanam:3><level:1>
paramAwmanaH	paramAwman<vargaH:nA><lifgam:puM><viBakwiH:2><vacanam:3><level:1>/paramAwman<vargaH:nA><lifgam:puM><viBakwiH:5><vacanam:1><level:1>/paramAwman<vargaH:nA><lifgam:puM><viBakwiH:6><vacanam:1><level:1>
paramAwmA	paramAwman<vargaH:nA><lifgam:puM><viBakwiH:1><vacanam:1><level:1>
parAvarwamAnam	parAvarwamAna<vargaH:nA><lifgam:puM><viBakwiH:2><vacanam:1><level:1>
parAvarwasva	para_Af_vqw1<prayogaH:karwari><lakAraH:lot><puruRaH:pra><vacanam:1><paxI:AwmanepaxI><XAwuH:vqwu><gaNaH:BvAxiH><level:1>
parAvarwayaw	para_Af_vqw1<prayogaH:karwari><lakAraH:lof><puruRaH:pra><vacanam:1><paxI:AwmanepaxI><XAwuH:vqwu><gaNaH:BvAxiH><level:1>
parAvarwayiwum	para_Af_vqw1_Nic<vargaH:avy><kqw_prawyayaH:wumun><XAwuH:vqwu><gaNaH:BvAxiH>
parAvarwayiwum	parA_vqw1_Nic<vargaH:avy><kqw_prawyayaH:wumun><XAwuH:vqwu><gaNaH:BvAxiH>
parAvarwsyawi	para_Af_vqw1<prayogaH:karwari><lakAraH:lqt><puruRaH:pra><vacanam:1><paxI:parasmEpaxI><XAwuH:vqwu><gaNaH:BvAxiH><level:1>/parA_vqwu1<prayogaH:karwari><lakAraH:lqt><puruRaH:pra><vacanam:1><paxI:parasmEpaxI><XAwuH:vqwu><gaNaH:BvAxiH><level:1>
parAvqwya	para_Af_vqw1<vargaH:avy><kqw_prawyayaH:lyap><XAwuH:vqwu><gaNaH:BvAxiH><level:0>
parAvqwya	para_A_vqw1<vargaH:avy><kqw_prawyayaH:lyap><XAwuH:prA_vqwu><gaNaH:BvAxiH><level:0>$
paricakRawe	pari_cakR1<prayogaH:karwari><lakAraH:lat><puruRaH:pra><vacanam:3><paxI:AwmanepaxI><XAwuH:cakRizf><gaNaH:axAxiH>
paricAyayan	paricAyayaw<vargaH:nA><lifgam:puM><viBakwiH:1><vacanam:1><level:1>
parIkRanwe	pari_IkRa1<prayogaH:karwari><lakAraH:lat><puruRaH:pra><vacanam:3><paxI:AwmanepaxI><XAwuH:IkRa><gaNaH:BvAxiH><level:1>
parIkRanwe	pari_IkRa1<prayogaH:karwari><lakAraH:lat><puruRaH:pra><vacanam:3><paxI:AwmanEpaxI><XAwuH:IkRa><gaNaH:BvAxiH><level:1>
parIkRArWinaH	parIkRArWin<vargaH:nA><lifgam:puM><viBakwiH:1><vacanam:3><level:1>/parIkRArWin<vargaH:nA><lifgam:puM><viBakwiH:2><vacanam:3><level:1>/parIkRArWin<vargaH:nA><lifgam:puM><viBakwiH:5><vacanam:1><level:1>/parIkRArWin<vargaH:nA><lifgam:puM><viBakwiH:6><vacanam:1><level:1>
parIkRArWI	parIkRArWin<vargaH:nA><lifgam:puM><viBakwiH:1><vacanam:1><level:1>
parIkRawAm	parIkRawA<vargaH:nA><lifgam:swrI><viBakwiH:2><vacanam:1><level:1>
parIkRawe	pari_IkR1<prayogaH:karwari><lakAraH:lat><puruRaH:pra><vacanam:1><paxI:AwmanEpaxI><XAwuH:IkRa><gaNaH:BvAxiH><level:1>
paripAlayan	pari_pAla1<kqw_prawyayaH:Sawq_lat><XAwuH:pAla><gaNaH:curAxiH><level:0><kqw_pratipadika:pAlayaw><vargaH:nA><lifgam:puM><viBakwiH:1><vacanam:1>
pariRvajamAnaH	pariRvajamAna<vargaH:nA><lifgam:puM><viBakwiH:1><vacanam:1><level:1>
pariRvajmAnaH	pariRvajmAna<vargaH:nA><lifgam:puM><viBakwiH:1><vacanam:1><level:1>
parisamApyawe	pari_sam_Ap1<prayogaH:karmaNi><lakAraH:lat><puruRaH:pra><vacanam:1><paxI:AwmanepaxI><XAwuH:ApLz><gaNaH:svAxiH>
parisWiwim	parisWiwi<vargaH:nA><lifgam:swrI><viBakwiH:2><vacanam:1><level:1>
pArivArikAH	pArivArika<vargaH:nA><lifgam:puM><viBakwiH:1><vacanam:1><level:1>
parivarwayiwum	pari_vqw3<vargaH:avy><kqw_prawyayaH:wumun><XAwuH:vqwu><gaNaH:curAxiH>
parivarwiwam	parivarwiwa<vargaH:nA><lifgam:napuM><viBakwiH:1><vacanam:1><level:1>
parivarwiwa	pari_vqw1<lifgam:puM><kqw_prawyayaH:kwa><XAwuH:vqwuz><gaNaH:BvAxiH><level:0>
parivarwiwaveSO	parivarwiwaveSa<vargaH:nA><lifgam:puM><viBakwiH:1><vacanam:2><level:1>
pariveRayAni	pari_viR1_Nic<prayogaH:karwari><lakAraH:lot><puruRaH:u><vacanam:1><paxI:parasmEpaxI><XAwuH:viR1><gaNaH:BvAxiH><level:1>
parivIjayanwIm	parivIjayanwI<vargaH:nA><lifgam:swrI><viBakwiH:2><vacanam:1><level:1>
paryacayayaw	pari_ci1_Nic<prayogaH:karwari><lakAraH:laf><puruRaH:pra><vacanam:1><paxI:parasmEpaxI><XAwuH:ci1><gaNaH:curAxiH><level:1>
paryaNayaw	pari_nI1<prayogaH:karwari><lakAraH:laf><puruRaH:pra><vacanam:1><paxI:parasmEpaxI><XAwuH:NIF><gaNaH:BvAxiH><level:1>
paryatan	paryataw<vargaH:nA><lifgam:puM><viBakwiH:1><vacanam:1><level:1>
paryatiwum	pari_at1<vargaH:avy><kqw_prawyayaH:wumun><XAwuH:ata><gaNaH:BvAxiH>
paryaveRayaw	pari_viR1_Nic<prayogaH:karwari><lakAraH:laf><puruRaH:pra><vacanam:1><paxI:parasmEpaxI><XAwuH:viR1><gaNaH:BvAxiH><level:1>
paryupAsawe	pari_upa_As1<prayogaH:karwari><lakAraH:lat><puruRaH:pra><vacanam:3><paxI:AwmanepaxI><XAwuH:Asaz><gaNaH:axAxiH>
pAwayiwum	paw1<vargaH:avy><kqw_prawyayaH:wumun><XAwuH:pawa><gaNaH:curAxiH>
pawixevaH	pawixeva<vargaH:nA><lifgam:puM><viBakwiH:1><vacanam:1><level:1>
pAxakanxukaKelam	pAxakanxukaKela<vargaH:nA><lifgam:puM><viBakwiH:2><vacanam:1><level:1>
pAyayiwvA	pA1_Nic<vargaH:avy><kqw_prawyayaH:kwvA><XAwuH:pA><gaNaH:BvAxiH><level:0>
piXawwe	api_XA1<prayogaH:karwari><lakAraH:lat><puruRaH:pra><vacanam:1><paxI:parasmEpaxI><XAwuH:XA><gaNaH:BvAxiH><level:1>
praBAviwaH	praBAviwa<vargaH:nA><lifgam:puM><viBakwiH:1><vacanam:1><level:1>
prAboXayaw	pra_buX1<prayogaH:karwari><lakAraH:laf><puruRaH:pra><vacanam:1><paxI:parasmEpaxI><XAwuH:buXir><gaNaH:curAxiH><level:1>
praboXayiwum	pra_buX1_Nic<vargaH:avy><kqw_prawyayaH:wumun><XAwuH:buXa><gaNaH:BvAxiH>
pracArayAmAsa	pra_car1_Nic<prayogaH:karwari><lakAraH:lit><puruRaH:pra><vacanam:1><paxI:parasmEpaxI><XAwuH:cara><gaNaH:BvAxiH><level:1>
pracArayiRyAmaH	pra_car2<prayogaH:karwari><lakAraH:lqt><puruRaH:u><vacanam:3><paxI:parasmEpaxI><XAwuH:cara><gaNaH:curAxiH><level:1>
prajvAlayiwum	pra_jval1_Nic<vargaH:avy><kqw_prawyayaH:wumun><XAwuH:jvala><gaNaH:BvAxiH>
prajvAlya	pra_jval1_Nic<vargaH:avy><kqw_prawyayaH:lyap><XAwuH:pra_jvala><gaNaH:curAxiH><level:0>$
prakASayawi	pra_kAS1_Nic<prayogaH:karwari><lakAraH:lat><puruRaH:pra><vacanam:1><paxI:parasmEpaxI><XAwuH:kASqz><gaNaH:BvAxiH>
prAkASayaw	pra_Af_kaSa1<prayogaH:karwari><lakAraH:laf><puruRaH:pra><vacanam:1><paxI:parasmEpaxI><XAwuH:kaSa><gaNaH:BvAxiH><level:1>
prakASayiwum	pra_kAS1_Nic<vargaH:avy><kqw_prawyayaH:wumun><XAwuH:kASq><gaNaH:BvAxiH>
prakatayanwi	pra_kat1_Nic<prayogaH:karwari><lakAraH:lat><puruRaH:pra><vacanam:3><paxI:parasmEpaxI><XAwuH:kate><gaNaH:BvAxiH><level:1>
prakatayawi	pra_kat1_Nic<prayogaH:karwari><lakAraH:lat><puruRaH:pra><vacanam:1><paxI:parasmEpaxI><XAwuH:kate><gaNaH:BvAdiH><level:1>
prakatiwavanwaH	prakatiwavaw<vargaH:nA><lifgam:puM><viBakwiH:1><vacanam:3><level:1>
prakatiwavanwO	prakatiwavaw<vargaH:nA><lifgam:puM><viBakwiH:1><vacanam:2><level:1>
prakatiwavawI	pra_kat1<kqw_prawyayaH:kwavawu><XAwuH:kata><gaNaH:BvAxiH><level:0><kqw_pratipadika:prakatiwavawI><vargaH:nA><lifgam:swrI><viBakwiH:1><vacanam:1>
prakqwijEH	prakqwija<vargaH:nA><lifgam:puM><viBakwiH:3><vacanam:3>
prakRAlayAmaH	pra_kRala1<prayogaH:karwari><lakAraH:lat><puruRaH:u><vacanam:3><paxI:parasmEpaxI><XAwuH:kRal><gaNaH:curAxiH><level:1>
prakRAlayaWa	pra_kRal1<prayogaH:karwari><lakAraH:lat><puruRaH:ma><vacanam:1><paxI:parasmEpaxI><XAwuH:kRala><gaNaH:curAxiH><level:1>
prakRAlayew	pra_kRal1<prayogaH:karwari><lakAraH:viXilif><puruRaH:pra><vacanam:1><paxI:parasmEpaxI><XAwuH:kRala><gaNaH:curAxiH><level:1>
pramucyawe	pra_muc1<prayogaH:karmaNi><lakAraH:lat><puruRaH:pra><vacanam:1><paxI:AwmanepaxI><XAwuH:mucLz><gaNaH:wuxAxiH>/pra_muc2<prayogaH:karwari><lakAraH:lat><puruRaH:pra><vacanam:1><paxI:AwmanepaxI><XAwuH:mucaz><gaNaH:curAxiH><level:0>
pramumoxa	pra_mux1<prayogaH:karwari><lakAraH:lit><puruRaH:pra><vacanam:1><paxI:parasmEpaxI><XAwuH:muxaz><gaNaH:BvAxiH><level:0>
praNaSyAmi	pra_naS1<prayogaH:karwari><lakAraH:lat><puruRaH:u><vacanam:1><paxI:parasmEpaxI><XAwuH:NaSaz><gaNaH:xivAxiH>.
praNipawanwIm	pranipawaw<vargaH:nA><lifgam:swrI><viBakwiH:2><vacaam:1><level:1>
praNipawya	pra_ni_paw1<vargaH:avy><kqw_prawyayaH:lyap><XAwuH:pawL><gaNaH:BvAxiH><level:0>
praNipawya	pra_ni_paw1<vargaH:avy><kqw_prawyayaH:lyap><XAwuH:pawL><gaNaH:BvAxiH><level:0>$
prApayan	pra_Ap1_Nic<kqw_prawyayaH:Sawq_lat><XAwuH:ApL><gaNaH:BvAxiH><level:0><kqw_pratipadika:prApayaw><vargaH:nA><lifgam:puM><viBakwiH:1><vacanam:1>
prApayiwum	pra_Ap1_Nic<vargaH:avy><kqw_prawyayaH:wumun><XAwuH:Aplq><gaNaH:svAxiH>
prApnuvanwaH	pra_Ap1<kqw_prawyayaH:kwavawu><XAwuH:ApL><gaNaH:svAxiH><level:0><kqw_pratipadika:prapnuvaw><vargaH:nA><lifgam:puM><viBakwiH:1><vacanam:3>
prApwavAn	pra_Ap1<kqw_prawyayaH:kwavawu><XAwuH:Aplq><gaNaH:curAxiH><level:0><kqw_pratipadika:prApwavaw><vargaH:nA><lifgam:puM><viBakwiH:1><vacanam:1>
prAraBawa	pra_Af_raB1<prayogaH:karwari><lakAraH:laf><puruRaH:pra><vacanam:1><paxI:AwmanepaxI><XAwuH:raBa><gaNaH:BvAxiH><level:1>
prAraBawe	pra_Af_raB1<prayogaH:karwari><lakAraH:lat><puruRaH:pra><vacanam:1><paxI:AwmanepaxI><XAwuH:raBaz><gaNaH:BvAxiH>
prAramBamANaH	prAramBamANa<vargaH:nA><lifgam:puM><viBakwiH:1><vacanam:1><level:1>
prarohanwi	pra_ruh1<prayogaH:karwari><lakAraH:lat><puruRaH:pra><vacanam:3><paxI:parasmEpaxI><XAwuH:ruha><gaNaH:BvAxiH><level:1>
prArwayamAnayA	prArwayamAnA<vargaH:nA><lifgam:swrI><viBakwiH:3><vacanam:1><level:1>
prArWayamAnayA	prArWayamAna<vargaH:nA><lifgam:swrI><viBakwiH:3><vacanam:1><level:1>
prArWiwavAn	prArWiwavaw<vargaH:nA><lifgam:puM><viBakwiH:1><vacanam:1><level:1>
prasaBaM	prasaBa<vargaH:avy><level:1>
praSamayiwum	pra_Sam1<vargaH:avy><kqw_prawyayaH:wumun><XAwuH:Samu><gaNaH:xivAxiH>
praSaMsanIyaM	praSaMsanIya<vargaH:nA><lifgam:puM><viBakwiH:2><vacanam:1><level:1>/praSaMsanIya<vargaH:nA><lifgam:napuM><viBakwiH:1><vacanam:1><level:1>/praSaMsanIya<vargaH:nA><lifgam:napuM><viBakwiH:2><vacanam:1><level:1>
praSaMsan	praSaMsaw<vargaH:nA><lifgam:puM><viBakwiH:1><vacanam:1><level:1>
prasArayiwum	pra_sq1_Nic<vargaH:avy><kqw_prawyayaH:wumun><XAwuH:sq><gaNaH:BvAxiH>
prasAxaye	pra_sax1_Nic<prayogaH:karwari><lakAraH:lat><puruRaH:u><vacanam:1><paxI:AwmanepaxI><XAwuH:RaxLz><gaNaH:BvAxiH>
prAsAxayiwum	pra_Af_sax1<vargaH:avy><kqw_prawyayaH:wumun><XAwuH:Raxa><gaNaH:curAxiH>
prasAxayiwum	pra_sax1<vargaH:avy><kqw_prawyayaH:wumun><XAwuH:Raxa><gaNaH:curAxiH>
prasAxayiwum	pra_sax1<vargaH:avy><kqw_prawyayaH:wumun><XAwuH:saxL><gaNaH:BvAxiH><level:0>
prasAxayiwum	pra_sax1<vargaH:avy><kqw_prawyayaH:wumun><XAwuH:saxL><gaNaH:BvAxiH><level:0>$
prasixXyew	pra_siX3<prayogaH:karwari><lakAraH:viXilif><puruRaH:pra><vacanam:1><paxI:parasmEpaxI>pra_RiXuz><gaNaH:xivAxiH>
prasWApayAmAsa	pra_sWA1_Nic<prayogaH:karwari><lakAraH:lit><puruRaH:pra><vacanam:1><paxI:parasmEpaxI><XAwuH:RTA><gaNaH:BvAxiH><level:0>
prasWiwavAn	prasWiwavaw<vargaH:nA><lifgam:puM><viBakwiH:1><vacanam:2><level;1>
pravAhayan	pravAhayaw<vargaH:nA><lifgam:puM><viBakwiH:1><vacanam:1><level:1>
praveSayiRyAmi	pra_viS1_Nic<prayogaH:karwari><lakAraH:lqt><puruRaH:u><vacanam:1><paxI:parasmEpaxI><XAwuH:viSaz><gaNaH:wuxAxiH><level:0>
pravilIyawe	pra_vi_lI1<prayogaH:karwari><lakAraH:lat><puruRaH:pra><vacanam:1><paxI:AwmanepaxI><XAwuH:lIf><gaNaH:xivAxiH>
pravyaWiwaH	pra_vyaW1<kqw_prawyayaH:kwa><XAwuH:vyaWaz><gaNaH:BvAxiH><lifgam:puM><viBakwiH:1><vacanam:1>
pravyaWiwAH	pra_vyaW1<kqw_prawyayaH:kwa><XAwuH:vyaWaz><gaNaH:BvAxiH><lifgam:puM><viBakwiH:1><vacanam:3>
pravyaWiwam	pravyaWiwa<vargaH:nA><lifgam:napuM><viBakwiH:1><vacanam:1><level:0>/pravyaWiwa<vargaH:nA><lifgam:puM><viBakwiH:2><vacanam:1><level:0>
prawiBUm	prawiBU<vargaH:nA><lifgam:puM><viBakwiH:2><vacanam:1><level:1>
prawijAne	prawi_jFA2<prayogaH:karwari><lakAraH:lat><puruRaH:pra><vacanam:1><paxI:AwmanepaxI><XAwuH:jFA><gaNaH:kryAxiH>
prawipAxaya	prawi_pax1<prayogaH:karwari><lakAraH:lot><puruRaH:ma><vacanam:1><paxI:parasmEpaxI><XAwuH:pax><gaNaH:curAxiH><level:1>
prawiSoXam	prawiSoXa<vargaH:nA><lifgam:napuM><viBakwiH:1><vacanam:1><level:1>/prawiSoXa<vargaH:nA><lifgam:napuM><viBakwiH:2><vacanam:1><level:1>
prawIyamAnaH	prawIyamAna<vargaH:nA><lifgam:puM><viBakwiH:1><vacanam:1><level:1>
prawyAgacCanwI	prawyAgacCanwI<vargaH:nA><lifgam:swrI><viBakwiH:1><vacanam:1><level:0>
prawyapAxayaw	prawi_pax1_Nic<prayogaH:karwari><lakAraH:laf><puruRaH:pra><vacanam:1><paxI:parasmEpaxI><XAwuH:paxaz><gaNaH:xivAxiH><level:0>
prawyAvarwayawa	prawi_Af_vqwu1_Nic<prayogaH:karwari><lakAraH:laf><puruRaH:pra><vacanam:1><paxI:AwmanepaxI><XAwuH:vqwu><gaNaH:BvAxiH><level:0>
praxaXmawuH	pra_XmA1<prayogaH:karwari><lakAraH:lit><puruRaH:pra><vacanam:2><<paxI:parasmEpaxIpra_XmA><gaNaH:BvAxiH>
prayacCawi	pra_yam2<prayogaH:karwari><lakAraH:lat><puruRaH:pra><vacanam:1><paxI:parasmEpaxI><XAwuH:yamaz><gaNaH:BvAxiH>
prAyacCaw	pra_xA1<prayogaH:karwari><lakAraH:laf><puruRaH:pra><vacanam:1><paxI:parasmEpaxI><XAwuH:xANc><gaNaH:BvAxiH><level:1>
prAyacCaw	pra_xA1<vargaH<prayogaH:karwari><lakAraH:laf><puruRaH:pra><vacanam:1><paxI:parasmEpaxI><XAwuH:xAN><gaNaH:BvAxiH><level:0>
prERiwvan	pra_IR1<vargaH:nA><kqw_prawyayaH:kwvw><lifgam:puM><viBakwiH:1><vacanam:1><level:1>
procyawe	pra_brU1<prayogaH:karmaNi><lakAraH:lat><puruRaH:pra><vacanam:1><paxI:AwmanepaxI><XAwuH:brUF><gaNaH:axAxiH>
prowsAhayaw	pra_uw_sah1<prayogaH:karwari><lakAraH:laf><puruRaH:pra><vacanam:1><paxI:parasmEpaxI><XAwuH:sah><gaNaH:xivAxiH>
pujArI	pujArin<vargaH:nA><lifgam:puM><viBakwiH:1><vacanam:1><level:1>
puruRavyAGra	puruRa-vyAGra<vargaH:nA><lifgam:puM><viBakwiH:8><vacanam:1>
puruRAxinI	puruRAxin<vargaH:nA><lifgam:swrI><viBakwiH:1><vacanam:1><level:1>
puruRowwamaxAsasya	puruRowwamaxAsa<vargaH:nA><lifgam:puM><viBakwiH:6><vacanam:1><level:1>
qRyaSqfgasya	qRyaSqfga<vargaH:nA><lifgam:puM><viBakwiH:6><vacanam:1><level:1>
rAjajyowiRiNA	rAjajyowiRin<vargaH:nA><lifgam:puM><viBakwiH:3><vacanam:1><level:1>
rAjyArXam	rAjyArXa<vargaH:nA><lifgam:puM><viBakwiH:2><vacanam:1><level:1>
rAjyasImAyAm	rAjyasImA<vargaH:nA><lifgam:swrI><viBakwiH:7><vacanam:1><level:1>
rAmagiryASrameRu	rAmagiryASrama<vargaH:nA><lifgam:puM><viBakwiH:7><vacanam:3><level:1>
ramaNaM	ramaNa<vargaH:nA><lifgam:puM><viBakwiH:2><vacanam:1><level:1>
ramanwi	ram1<prayogaH:karwari><lakAraH:lat><puruRaH:pra><vacanam:3><paxI:parasmEpaxI><XAwuH:ramuz><gaNaH:BvAxiH>
rAmasIwAm	rAmasIwA<vargaH:nA><lifgam:puM><viBakwiH:1><vacanam:1><level:1>
rAmawIrWasya	rAmawIrWa<vargaH:nA><lifgam:puM><viBakwiH:6><vacanam:1><level:1>
rameSa	rameSa<vargaH:nA><lifgam:puM><viBakwiH:8><vacanam:1><level:1>
raWAH	raWa<vargaH:nA><lifgam:puM><viBakwiH:1><vacanam:3>
rotIm	rotI<vargaH:nA><lifgam:swrI><viBakwiH:2><vacanam:1><level:1>
rotI	rotI<vargaH:nA><lifgam:swrI><viBakwiH:1><vacanam:1><level:1>
rUkRArotI	rotI<vargaH:nA><lifgam:swrI><viBakwiH:1><vacanam:1><level:1>
rUpyakANAM	rUpyaka<vargaH:nA><lifgam:napuM><viBakwiH:6><vacanam:3><level:1>
rUpyakANi	rUpyaka<vargaH:nA><lifgam:napuM><viBakwiH:1><vacanam:3><level:1>/rUpyaka<vargaH:nA><lifgam:napuM><viBakwiH:2><vacanam:3><level:1>
rUpyakEH	rUpyaka<vargaH:nA><lifgam:napuM><viBakwiH:3><vacanam:3><level:1>
saFjanayan	saFjanayaw<vargaH:nA><lifgam:puM><viBakwiH:1><vacanam:1><level:2>
saFjAnIwe	sam_jFA2<prayogaH:karwari><lakAraH:lat><puruRaH:pra><vacanam:1><paxI:AwmanepaxI><XAwuH:jFA><gaNaH:kryAxiH><level:0>
saFjAyawe	sam_jan3<prayogaH:karwari><lakAraH:lat><puruRaH:pra><vacanam:1><paxI:AwmanepaxI><XAwuH:janIz><gaNaH:xivAxiH>
safkruXyasi	sam_kruX1<prayogaH:karwari><lakAraH:lat><puruRaH:ma><vacanam:1><paxI:parasmEpaxI><XAwuH:kruXa><gaNaH:xivAxiH><level:1>
sahamawiH	sahamawi<vargaH:nA><lifgam:swrI><viBakwiH:1><vacanam:1><level:1>
sahapATinaH	sahapATin<vargaH:nA><lifgam:puM><viBakwiH:1><vacanam:3><level:1>/sahapATin<vargaH:nA><lifgam:puM><viBakwiH:2><vacanam:3><level:1>/sahapATin<vargaH:nA><lifgam:puM><viBakwiH:5><vacanam:1><level:1>/sahapATin<vargaH:nA><lifgam:puM><viBakwiH:6><vacanam:1><level:1>
sahapATinAm	sahapATin<vargaH:nA><lifgam:puM><viBakwiH:6><vacanam:3><level:1>
sahapATI	sahapATin<vargaH:nA><lifgam:puM><viBakwiH:1><vacanam:1><level:1>
sahayogena	sahayoga<vargaH:nA><lifgam:puM><viBakwiH:3><vacanam:1><level:1>
sahayoginaH	sahayogin<vargaH:nA><lifgam:puM><viBakwiH:1><vacanam:3><level:1>
sAkRAwkurvanwaH	sAkRAwkurvaw<vargaH:nA><lifgam:puM><viBakwiH:1><vacanam:3><level:1>
samAcaran	sam_Af_car1<prayogaH:karwari><lakAraH:laf><puruRaH:pra><vacanam:3><paxI:parasmEpaxI><XAwuH:caraz><gaNaH:BvAxiH>
samAhUya	sam_Af_hu1<vargaH:avy><kqw_prawyayaH:lyap><XAwuH:hudi><gaNaH:juhowyAxiH><level:0>
samAhUya	sam_A_hu1<vargaH:avy><kqw_prawyayaH:lyap><XAwuH:hudi><gaNaH:juhowyAxiH><level:0>$
samajAyawa	sama_ji1_Nic<prayogaH:karwari><lakAraH:laf><puruRaH:pra><vacanam:1><paxI:AwmanepaxI><XAwuH:ji1><gaNaH:BvAxiH><level:1>/sam_jan2<prayogaH:karwari><lakAraH:laf><puruRaH:pra><vacanam:1><paxI:parasmEpaxI><XAwuH:jan><gaNaH:xivAxiH><level:1>
samakewayawa	sam_kew1<prayogaH:karwari><lakAraH:laf><puruRaH:pra><vacanam:1><paxI:AwmanepaxI><XAwuH:kewa><gaNaH:curAxiH><level:1>
samaqpya	saM_q1_Nic<vargaH:avy><kqw_prawyayaH:lyap><XAwuH:q><gaNaH:axAdiH><level:
samaqpya	saM_q1_Nic<vargaH:avy><kqw_prawyayaH:lyap><XAwuH:sam_q><gaNaH:axAdiH><level:
samarpayiwum	sam_q1_Nic<vargaH:avy><kqw_prawyayaH:wumun><XAwuH:q><gaNaH:BvAxiH>
samarpiwavAn	samarpiwavaw<vargaH:nA><lifgam:puM><viBakwiH:1><vacanam:1><level:1>
samarpya	sam_q1_Nic<vargaH:avy><kqw_prawyayaH:lyap><XAwuH:q><gaNaH:BvAxiH><level:0>
samarpya	sam_q1_Nic<vargaH:avy><kqw_prawyayaH:lyap><XAwuH:q><gaNaH:BvAxiH><level:0>$
samarpyewa	sam_arpa1<prayogaH:karwari><lakAraH:viXi><puruRaH:pra><vacanam:1><paxI:AwmanepaxI><XAwuH:q><gaNaH:BvAxiH><level:1>
samAruhya	sam_Af_ruh1<vargaH:avy><kqw_prawyayaH:lyap><XAwuH:ruhaz><gaNaH:BvAxiH><level:0>
samAsAxya	sam_Af_sax2<vargaH:avy><kqw_prawyayaH:lyap><XAwuH:Raxlqz><gaNaH:wuxAxiH><level:0>
samAsIxanwi	sam_Af_sax1<prayogaH:karwari><lakAraH:lat><puruRaH:pra><vacanam:3><paxI:parasmEpaxI><XAwuH:Raxa><gaNaH:BvAxiH><level:1>
samavAhayaw	sam_vAh1<prayogaH:karwari><lakAraH:laf><puruRaH:pra><vacanam:1><paxI:uBayapaxI><XAwuH:vAhi><gaNaH:BvAxiH><level:1>
samAxixeSa	sam_Af_xiS1<prayogaH:karwari><lakAraH:lit><puruRaH:pra><vacanam:1><paxI:parasmEpaxI><XAwuH:xiSa><gaNaH:wuxAxiH><level:0>
Samayiwum	Sam1_Nic<vargaH:avy><kqw_prawyayaH:wumun><XAwuH:Samu><gaNaH:xibAxiH><level:0>
Samayiwum	Sam1_Nic<vargaH:avy><kqw_prawyayaH:wumun><XAwuH:Samu><gaNaH:xibAxiH><level:0>$
samBAlaya	sam_Bal1_Nic<prayogaH:karwari><lakAraH:lot><puruRaH:ma><vacanam:1><paxI:parasmEpaxI><XAwuH:Bala><gaNaH:BvAxiH><level:1>
samBAlayiwum	sam_Bal1<vargaH:avy><kqw_prawyayaH:wumun><XAwuH:Bala><gaNaH:curAxiH>
samBAliwavAn	samBAliwavaw<vargaH:nA><lifgam:puM><viBakwiH:1><vacanam:1><level:1>
samBAvayew	sam_BU2<prayogaH:karwari><lakAraH:viXilif><puruRaH:pra><vacanam:1><paxI:parasmEpaxI><XAwuH:Buvo><gaNaH:curAxiH><level:1>
saMjFEH	saFjFa<vargaH:nA><lifgam:puM><viBakwiH:3><vacanam:3>
sAMKyam	sAfKya<vargaH:nA><lifgam:puM><viBakwiH:2><vacanam:1>
sammAnayawi	sam_mAna1<prayogaH:karwari><lakAraH:lat><puruRaH:pra><vacanam:1><paxI:parasmEpaxI><XAwuH:mAna><gaNaH:curAxiH><level:1>
sammeliwum	sam_mil1<vargaH:avy><kqw_prawyayaH:wumun><XAwuH:mila><gaNaH:wuxAxiH>
sammKe	sammuKa<vargaH:nA><lifgam:puM><viBakwiH:7><vacanam:1><level:1>
sammohayan	sammohayaw<vargaH:nA><lifgam:puM><viBakwiH:1><vacanam:1><level:1>
saMniyamya	sam_ni_yam1<vargaH:avy><kqw_prawyayaH:lyap><XAwuH:yamoz><gaNaH:BvAxiH>
sampaw	sampax<vargaH:nA><lifgam:swrI><viBakwiH:2><vacanam:1>
sampAxayanwi	sam_pax1<prayogaH:karwari><lakAraH:lat><puruRaH:pra><vacanam:3><paxI:parasmEpaxI><XAwuH:pax1><gaNaH:curAxiH><level:1>
sampAxayiwum	sam_pax_Nic1<vargaH:avy><kqw_prawyayaH:wumun><XAwuH:paxa><gaNaH:xivAxiH>
sampAxya	sam_pax1_Nic<vargaH:avy><kqw_prawyayaH:lyap><XAwuH:paxa><gaNaH:BvAxiH>
samprekRya	sam_pra_IkR1<kqw_prawyayaH:Sawq_lat><XAwuH:IkRaz><gaNaH:BvAxiH><lifgam:puM><viBakwiH:1><vacanam:1>
samprINaya	sam_prI1<prayogaH:karwari><lakAraH:lot><puruRaH:maXyama><vacanam:1><paxI:parasmEpaxI><XAwuH:prIF><gaNaH:kryAxiH><leve:0>
samrAt	samrAj<vargaH:nA><lifgam:puM><viBakwiH:1><vacanam:1><level:1>
SaMsanwi	SaMs1<prayogaH:karwari><lakAraH:lat><puruRaH:pra><vacanam:1><paxI:parasmEpaxI><XAwuH:SaMsuz><gaNaH:BvAxiH><level:0>
SaMsasi	SaMs1<prayogaH:karwari><lakAraH:lat><puruRaH:ma><vacanam:1><paxI:parasmEpaxI><XAwuH:SaMsuz><gaNaH:BvAxiH>
SaMsawi	SaMs1<prayogaH:karwari><lakAraH:lat><puruRaH:pra><vacanam:1><paxI:parasmEpaxI><XAwuH:SaMsuz><gaNaH:BvAxiH>
saMskqwaBARAyAH	saMskqwaBARA<vargaH:nA><lifgam:swrI><viBakwiH:6><vacanam:1><level:1>
saMskqwajFaH	saMskqwajFa<vargaH:nA><lifgam:puM><viBakwiH:1><vacanam:1><level:1>
saMSoBawe	sam_SuB1<prayogaH:karwari><lakAraH:lat><puruRaH:pra><vacanam:1><paxI:AwmanepaxI><XAwuH:SuBa><gaNaH:BvAxiH><level:1>
saMvAhayiwum	sam_vah_Nic1<vargaH:avy><kqw_prawyayaH:wumun><XAwuH:vaha><gaNaH:BvAxiH>
saMvAhayiwum	sam_vah_Nic1<vargaH:avy><kqw_prawyayaH:wumun><XAwuHvaha:><gaNaH:BvAxiH>
saMvAhyamAnam	saMvAhyamAn<vargaH:nA><lifgam:puM><viBakwiH:1><vacanam:2><level:1>
saMvarxXiwA	sam_vqX1<prayogaH:karwari><lakAraH:lut><puruRaH:pra><vacanam:1><paxI:parasmEpaxI><XAwuH:vqXu><gaNaH:BvAxiH><leve:0>
samwrotya	sam_wruta1<vargaH:avy><kqw_prawyayaH:lyap><XAwuH:wruta><gaNaH:wuxAxiH><level:0>/samwrotyasam_wruta2<vargaH:avy><kqw_prawyayaH:lyap><XAwuH:wruta><gaNaH:curAxiH><level:0>
samwrotya	sam_wruta1<vargaH:avy><kqw_prawyayaH:lyap><XAwuH:wruta><gaNaH:wuxAxiH><level:0>$/samwrotyasam_wruta2<vargaH:avy><kqw_prawyayaH:lyap><XAwuH:wruta><gaNaH:curAxiH><level:0>
saMyacCawe	sam_yam1<prayogaH:karwari><lakAraH:lat><puruRaH:pra><vacanam:1><paxI:AwmanepaxI><XAwuH:xAN><gaNaH:BvAxiH><level:0>
saMyamawAm	sam_yam3_Nic<kqw_prawyayaH:Sawq_lat><XAwuH:yamaz><gaNaH:curAxiH><lifgam:puM><viBakwiH:6><vacanam:3>
saMyojayAmi	sam_yuj1_Nic<prayogaH:karwari><lakAraH:lat><puruRaH:uwa><vacanam:1><paxI:parasmEpaxI><XAwuH:yujir><gaNaH:ruXAxiH><level:0>
saMyojayawi	sam_yuj3<prayogaH:karwari><lakAraH:lat><puruRaH:pra><vacanam:1><paxI:parasmEpaxI><XAwuH:yuj><gaNaH:curAxiH><level:1>
saMyojayiwum	sam_yuj1_Nic<vargaH:avy><kqw_prawyayaH:wumun><XAwuH:yuj><gaNaH:BvAxiH><level:0>$
saMyojayiwum	sam_yuj1_Nic<vargaH:avy><kqw_prawyayaH:wumun><XAwuH:yuj><gaNaH:BvAxiH><level:0>/sam_yuj1<vargaH:avy><kqw_prawyayaH:wumun><XAwuH:yuja><gaNaH:curAxiH>
saMyojayiwum	sam_yuj1<vargaH:avy><kqw_prawyayaH:wumun><XAwuH:yuja><gaNaH:curAxiH>
saMyokwum	saM_yuj1<vargaH:avy><kqw_prawyayaH:wumun><XAwuH:yujaz><gaNaH:xivAxiH><level:0>
sanniBaM	sanniBa<vargaH:nA><lifgam:puM><viBakwiH:2><vacanam:1><level:1>
sanwApayawi	sam_wap1_Nic<prayogaH:karwari><lakAraH:lat><puruRaH:pra><vacanam:1><paxI:parasmEpaxI><XAwuH:ciF><gaNaH:wanAxiH><level:1>
sanyAsinaH	sannyAsin<vargaH:nA><lifgam:puM><viBakwiH:6><vacanam:1><level:1>
sanyAsinam	sanyAsin<vargaH:nA><lifgam:puM><viBakwiH:2><vacanam:1><level:1>
sanyAsI	sannyAsin<vargaH:nA><lifgam:puM><viBakwiH:1><vacanam:1><level:1>
SarAsanam	sarAsana<vargaH:nA><lifgam:napuM><viBakwiH:1><vacanam:1><level:1>
SarAsanam	sarAsana<vargaH:nA><lifgam:napum><viBakwiH:2><vacaam:1><level:1>
Sarax	Sarax<vargaH:nA><lifgam:puM><viBakwiH:1><vacanam:1><level:1>
sarvapraWamam	sarvapraWama<vargaH:nA><lifgam:napuM><viBakwiH:2><vacanam:1><level:1>
sasuKam	sa_suKa<vargaH:nA><lifgam:napuM><viBakwiH:1><vacanam:1><level:1>
SAswrArWI	SAswrArWin<vargaH:nA><lifgam:puM><viBakwiH:1><vacanam:1><level:1>
sawarjanaM	sawarjana<vargaH:nA><lifgam:napuM><viBakwiH:1><vacanam:1><level:1>
SawaSaH	SawaSaH<vargaH:avy><level:1>
sawkarwum	saw_kq1<vargaH:avy><kqw_prawyayaH:wumun><XAwuH:dukqF><gaNaH:wanAxiH>
sawkromi	saw_kq3<prayogaH:karwari><lakAraH:lat><puruRaH:u><vacanam:1><paxI:parasmEpaxI><XAwuH:dukqF><gaNaH:BvAxiH><level:1>
sAwvikam	sAwvika<vargaH:nA><lifgam:napuM><viBakwiH:2><vacanam:1>
sAXayiwum	sAX1<vargaH:avy><kqw_prawyayaH:wumun><XAwuH:sAXa><gaNaH:xivAxiH>
saxqS	saxqS<vargaH:nA><lifgam:puM><viBakwiH:1><vacanam:1><level:1>
SayAnaH	SayAna<vargaH:nA><lifgam:puM><viBakwiH:1><vacanam:1><level:1>
SayAnaM	SayAna<vargaH:nA><lifgam:puM><viBakwiH:2><vacanam:1><level:1>
senAnInAm	senAnin<vargaH:nA><lifgam:puM><viBakwiH:6><vacanam:3>
SikRArWinaH	SikRArWin<vargaH:nA><lifgam:puM><viBakwiH:1><vacanam:3><level:1>/SikRArWin<vargaH:nA><lifgam:puM><viBakwiH:2><vacanam:3><level:1>/SikRArWin<vargaH:nA><lifgam:puM><viBakwiH:5><vacanam:3><level:1>/SikRArWin<vargaH:nA><lifgam:puM><viBakwiH:6><vacanam:3><level:1>
SikRayiwum	SikR1_Nic<vargaH:avy><kqw_prawyayaH:wumun><XAwuH:SikRa><gaNaH:BvAxiH>
SivAjiH	SivAji<vargaH:nA><lifgam:puM><viBakwiH:1><vacanam:1><level:1>
SivAjim	SivAji<vargaH:nA><lifgam:puM><viBakwiH:2><vacanam:1><level:1>
sixXyawi	siX3<prayogaH:karwari><lakAraH:lat><puruRaH:pra><vacanam:1><paxI:parasmEpaxI><XAwuH:RiXuz><gaNaH:xivAxiH>
smArayiwvA	smara<vargaH:avy><kqw_prawyayaH:kwvA><XAwuH:smara><gaNaH:BvAxiH><level:0>
snigXacCAyAwaruRu	snigXacCAyAwaru<vargaH:nA><lifgam:puM><viBakwiH:7><vacanam:3><level:1>
SOcAlayam	SOcAlaya<vargaH:nA><lifgam:puM><viBakwiH:2><vacanam:1><level:1>
soDum_arhasi	saha1<vargaH:avy><kqw_prawyayaH:wumun><XAwuH:Raha><gaNaH:BvAxiH>_arh1<prayogaH:karwari><lakAraH:lat><puruRaH:ma><vacanam:1><paxI:parasmEpaxI><XAwuH:arhaz><gaNaH:BvAxiH>
soDum	sah1<vargaH:avy><kqw_prawyayaH:wumun><XAwuH:Raha><gaNaH:BvAxiH>
soDum	saha1<vargaH:avy><kqw_prawyayaH:wumun><XAwuH:Raha><gaNaH:BvAxiH>
spqhaH	spqha<vargaH:nA><lifgam:puM><viBakwiH:1><vacanam:1>
spqhayamANaH	spqhayamANa<vargaH:nA><lifgam:puM><viBakwiH:1><vacanam:1><level:1>
sprihayamAnaH	sprihayamAna<vargaH:nA><lifgam:puM><viBakwiH:1><vacanam:1><level:1>
SqNvan	SqNvaw<vargaH:nA><lifgam:puM><viBakwiH:1><vacanam:1><level:0>
sqRtAnnam	sqRtAnna<vargaH:nA><lifgam:puM><viBakwiH:2><vacanam:1>
SramikaH	Sramika<vargaH:nA><lifgam:puM><viBakwiH:1><vacanam:1><level:1>
SravaNaM	SravaNa<vargaH:nA><lifgam:napuM><viBakwiH:1><vacanam:1><level:1>
SrAvaNaM	SrAvaNa<vargaH:nA><lifgam:napuM><viBakwiH:1><vacanam:1><level:1>
SrAvayawi	Sru1_Nic<prayogaH:karwari><lakAraH:lat><puruRaH:pra><vacanam:1><paxI:parasmEpaxI><XAwuH:Sru><gaNaH:wanAxiH><level:1>
SrAvayiwum	Sru1_Nic<vargaH:avy><kqw_prawyayaH:wumun><XAwuH:Sru><gaNaH:wanAxiH>
SrAvayiwvA	Sru1_Nic<vargaH:avy><kqw_prawyayaH:kwvA><XAwuH:Sru><gaNaH:wanAxiH>
SrAviwavAn	SrAviwavaw<vargaH:nA><lifgam:puM><viBakwiH:1><vacanam:1><level:1>
SrAviwavawi	SrAviwavawi<vargaH:nA><lifgam:strI><viBakwiH:1><vacanam:1><level:1>
SrAviwavawI	SrAviwavawI<vargaH:nA><lifgam:swrI><viBakwiH:1><vacanam:1><level:1>
SrIjavAharalAlaneharave	SrIjavAharalAlaneharu<vargaH:nA><lifgam:puM><viBakwiH:4><vacanam:1><level:1>
SrIjavAharalAlaneharuH	SrIjavAharalAlaneharu<vargaH:nA><lifgam:puM><viBakwiH:1><vacanam:1><level:1>
SrImAlavIyaH	SrImAlavIya<vargaH:nA><lifgam:puM><viBakwiH:1><vacanam:1><level:1>
SrIrAmakqRNaparamahaMsaH	SrIrAmakqRNaparamahaMsa<vargaH:nA><lifgam:puM><viBakwiH:1><vacanam:1><level:1>
SrIvixyAsAgaraH	SrIvixyAsAgara<vargaH:nA><lifgam:puM><viBakwiH:1><vacanam:1><level:1>
suGoRamaNipuRpakO	suGoRamaNipuRpakO<vargaH:nA><lifgam:puM><viBakwiH:2><vacanam:1>
sunIrAm	sunIrA<vargaH:nA><lifgam:swrI><viBakwiH:2><vacanam:1><level:1>
sunIrA	sunIrA<vargaH:nA><lifgam:swrI><viBakwiH:1><vacanam:1><level:1>
sunIrAyAH	sunIrA<vargaH:nA><lifgam:swrI><viBakwiH:6><vacanam:1><level:1>
sunIre	sunIrA<vargaH:nA><lifgam:swrI><viBakwiH:8><vacanam:1><level:1>
surakRAm	surakRA<vargaH:nA><lifgam:swrI><viBakwiH:1><vacanam:2><level:1>
suramyAH	suramya<vargaH:nA><lifgam:puM><viBakwiH:1><vacanam:3><level:1>
suramyam	suramya<vargaH:nA><lifgam:napuM><viBakwiH:2><vacanam:1><level:1>
suramyeRu	suramya<vargaH:nA><lifgam:napuM><viBakwiH:7><vacanam:3><level:1>
SuSrURasva	Su_SrU1_san<prayogaH:karwari><lakAraH:lot><puruRaH:ma><vacanam:1><paxI:parasmEpaxI><XAwuH:SrU><gaNaH:wanAxiH><level:1>
suvicArya	su_vi_car1_Nic<vargaH:avy><kqw_prawyayaH:lyap><XAwuH:cara><gaNaH:BvAxiH><level:0>
suvicArya	su_vi_car1_Nic<vargaH:avy><kqw_prawyayaH:lyap><XAwuH:cara><gaNaH:BvAxiH><level:0>$
suXArayawu	su_Xq1_Nic<prayogaH:karwari><lakAraH:lot><puruRaH:pra><vacanam:1><paxI:parasmEpaxI><XAwuH:Xq><gaNaH:BvAxiH><level:1>
svAmivivekAnanxaH	svAmivivekAnanxa<vargaH:nA><lifgam:puM><viBakwiH:1><vacanam:1><level:1>
svAmixayAnanxaH	svAmixayAnanxa<vargaH:nA><lifgam:puM><viBakwiH:1><vacanam:1><level:1>
svawanwraxeSam	svawanwradeSam<vargaH:nA><lifgam:puM><viBakwiH:1><vacanam:1><level:1>
svaxan	svaxaw<vargaH:nA><lifgam:puM><viBakwiH:1><vacanam:1><level:1>
svAxiRtAni	svAxiRta<vargaH:nA><lifgam:napuM><viBakwiH:1><vacanam:1><level:3>
svIkarowi	svI_kq1<prayogaH:karwari><lakAraH:lat><puruRaH:pra><vacanam:1><paxI:parasmEpaxI><XAwuH:svIkq><gaNaH:wanAxiH><level:1>
svIkarwum	svI_kq1<vargaH:avy><kqw_prawyayaH:wumun><XAwuH:dukqF><gaNaH:wanAxiH>
svIkqwya	svI_kq3<vargaH:avy><kqw_prawyayaH:lyap><XAwuH:dukqF><gaNaH:wuxAxiH><level:0>
svIkqwya	svI_kq3<vargaH:avy><kqw_prawyayaH:lyap><XAwuH:dukqF><gaNaH:wuxAxiH><level:0>$
svIkuryuH	svI_kq3<prayogaH:karwari><lakAraH:viXilif><puruRaH:pra><vacanam:3><paxI:parasmEpaxI><XAwuH:dukqF><gaNaH:wanAxiH><level:1>
sWagayiwvA	sWA1_Nic<vargaH:avy><kqw_prawyayaH:kwvA><XAwuH:RTA><gaNaH:BvAxiH><level:0>
swAmi	swAmI<vargaH:nA><lifgam:puM><viBakwiH:6><vacanam:1><level:1>
sWApayiwvA	sWA1_Nic<vargaH:avy><kqw_prawyayaH:kwvA><XAwuH:RTA><gaNaH:BvAxiH><level:0>
sWApiwvA	sWA1<vargaH:avy><kqw_prawyayaH:kwvA><XAwuH:RTA><gaNaH:BvAxiH><level:0>
SyAlAH	SyAla<vargaH:nA><lifgam:puM><viBakwiH:1><vacanam:3>
SyAmapatte	SyAmapatta<vargaH:nA><lifgam:napuM><viBakwiH:7><vacanam:1><level:1>
uccArayan	uccArayaw<vargaH:nA><lifgam:puM><viBakwiH:1><vacanam:1><level:1>
unmIliwaM	unmIlwa<vargaH:nA><lifgam:napum><viBakwiH:1><vacanam:1><level:1>
unmiRan	uw_miR1<kqw_prawyayaH:Sawq_lat><XAwuH:miRuz><gaNaH:BvAxiH><lifgam:puM><viBakwiH:1><vacanam:1>
upacariwum	upa_car1<vargaH:avy><kqw_prawyayaH:wumun><XAwuH:cara><gaNaH:BvAxiH>
upahAragqham	upahAragqha<vargaH:nA><lifgam:napuM><viBakwiH:2><vacanam:1><level:1>
upahAsakArI	upahAsakArin<vargaH:nA><lifgam:puM><viBakwiH:1><vacanam:1><level:1>
upahAsayawi	upa_has1_Nic<prayogaH:karwari><lakAraH:lat><puruRaH:pra><vacanam:1><paxI:parasmEpaxI><XAwuH:has1><gaNaH:BvAxiH><level:1>
upajuhvawi	upa_hu1<prayogaH:karwari><lakAraH:lat><puruRaH:pra><vacanam:3><paxI:parasmEpaxI><XAwuH:hu><gaNaH:juhowyAxiH>
upakalpayAmi	upa_kalp1<prayogaH:karwari><lakAraH:lat><puruRaH:uwa><vacanam:1><paxI:parasmEpaxI><XAwuH:kLp><gaNaH:ruXAxiH><level:0>
upakArArWam	upakAra<vargaH:nA><lifgam:napuM><viBakwiH:1><vacanam:1>
upakqpayAmi	upa_kqp1<prayogaH:karwari><lakAraH:lat><puruRaH:u><vacanam:1><paxI:parasmEpaxI><XAwuH:kqpU><gaNaH:BvAxiH><level:1>
upapawawi	upa_paw1<prayogaH:karwari><lakAraH:lat><puruRaH:pra><vacanam:1><paxI:parasmEpaxI><XAwuH:pawL><gaNaH:BvAxiH><level:0>
uparamew	upa_ram1<prayogaH:karwari><lakAraH:viXilif><puruRaH:pra><vacanam:1><paxI:AwmanepaxI>upa_ramuz><gaNaH:BvAxiH>
upArjiwaH	upArjiwa<vargaH:nA><lifgam:puM><viBakwiH:1><vacanam:1><level:1>
upArjiwaM	upArjiwa<vargaH:nA><lifgam:napuM><viBakwiH:1><vacanam:1><level:1>/upArjiwa<vargaH:nA><lifgam:napuM><viBakwiH:2><vacanam:1><level:1>/upArjiwa<vargaH:nA><lifgam:puM><viBakwiH:2><vacanam:1><level:1>
upArjiwavAn	upArjiwavaw<vargaH:nA><lifgam:puM><viBakwiH:1><vacanam:1><level:1>
upasafgamya	upa_sam_gam1<vargaH:avy><kqw_prawyayaH:lyap><XAwuH:gamL><gaNaH:BvAxiH><level:0>
upasarpAvaH	upa_sqp1<prayogaH:karwari><lakAraH:lat><puruRaH:u><vacanam:2><paxI:parasmEpaxI><XAwuH:sqpa><gaNaH:BvAxiH><level:1>
upASliRya	upa_Af_SliR<vargaH:avy><kqw_prawyayaH:lyap><XAwuH:SliR><gaNaH:BvAxiH><level:0>
upASliRya	up_A_SliR<vargaH:avy><kqw_prawyayaH:lyap><XAwuH:SliR><gaNaH:BvAxiH><level:0>$
upaspqSan	upa_spqS1<kqw_prawyayaH:Sawq_lat><XAwuH:spqSaz><gaNaH:wuxAxiH><level:0><kqw_pratipadika:upaspqSaw><vargaH:nA><lifgam:puM><viBakwiH:1><vacanam:1>
upAsva	upa_Asa1<prayogaH:karwari><lakAraH:lot><puruRaH:ma><vacanam:1><paxI:AtmanepaxI><XAwuH:Asa><gaNaH:axAxiH><level:1>
upasWApayanwi	upa_sWA1_Nic<prayogaH:karwari><lakAraH:lat><puruRaH:pra><vacanam:3><paxI:parasmEpaxI><XAwuH:RTA><gaNaH:BvAxiH><level:1>
upasWApayiwum	upa_sWA1_Nic<vargaH:avy><kqw_prawyayaH:wumun><XAwuH:RTA><gaNaH:BvAxiH>
upasWApiwavAn	upasWApiwavaw<vargaH:nA><lifgam:puM><viBakwiH:1><vacanam:1><level:1>
upAveSayam	upa_Af_viS1_Nic<prayogaH:karwari><lakAraH:laf><puruRaH:u><vacanam:1><paxI:parasmEpaxI><XAwuH:viSa><gaNaH:wuxAxiH><level:0>
upaXAraya	upa_Xq1_Nic<prayogaH:karwari><lakAraH:lot><puruRaH:ma><vacanam:1><paxI:parasmEpaxI><XAwuH:XqF><gaNaH:BvAxiH>/upa_Xq2_Nic<prayogaH:karwari><lakAraH:lot><puruRaH:ma><vacanam:1><paxI:parasmEpaxI><XAwuH:Xqf><gaNaH:BvAxiH>
upaxiSyamAnam	upaxiSyamAna<vargaH:nA><lifgam:puM><viBakwiH:2><vacanam:1><level:1>
upayokwum	upa1yuj<vargaH:avy><kqw_prawyayaH:wumun><XAwuH:yuja><gaNaH:xivAxiH>
upayujyawe	up_yuj1<prayogaH:karwari><lakAraH:lat><puruRaH:pra><vacanam:1><paxI:parasmEpaxI><XAwuH:yujir><gaNaH:ruXAxiH><level:0>
upekRiwavAn	upekRiwavaw<vargaH:nA><lifgam:puM><viBakwiH:1><vacanam:1><level:1>
upekRiwavanwaH	upekRiwavaw<vargaH:nA><lifgam:puM><viBakwiH:1><vacanam:3><level:1>
upekRiwavanwO	upekRiwavaw<vargaH:nA><lifgam:puM><viBakwiH:1><vacanam:2><level:1>
uwafgavarwinO	uwafgavarwin<vargaH:nA><lifgam:puM><viBakwiH:1><vacanam:2><level:1>
uwpawanwi	ux_paw1<prayogaH:karwari><lakAraH:lat><puruRaH:pra><vacanam:3><paxI:parasmEpaxI><XAwuH:pwL><gaNaH:BvAxiH><level:1>
uwpAxayanwi	uw_paw1<prayogaH:karwari><lakAraH:lat><puruRaH:pra><vacanam:3><paxI:parasmEpaxI><XAwuH:pawl><gaNaH:BvAxiH><level:0>
uwpaxyawe	uw_pax1<prayogaH:karwari><lakAraH:lat><puruRaH:pra><vacanam:1><paxI:AwmanepaxI><XAwuH:paxL><gaNaH:xivAxiH><level:0>
uwpITikAyAm	uwpITikA<vargaH:nA><lifgam:swrI><viBakwiH:7><vacanam:1><level:1>
uwsasarja	uw_sqj1<prayogaH:karwari><lakAraH:lit><puruRaH:pra><vacanam:1><paxI:AtmanepaxI><XAwuH:sqja><gaNaH:BvAxiH><level:1>
uwsIxeyuH	uw_sax1<prayogaH:karwari><lakAraH:viXilif><puruRaH:pra><vacanam:bahu><paxI:parasmEpaxI><XAwuH:RaxLz><gaNaH:BvAxiH>
uwsqjAmi	uw_sqj2<prayogaH:karwari><lakAraH:lat><puruRaH:u><vacanam:1><paxI:parasmEpaxI><XAwuH:sqjaz><gaNaH:wuxAxiH>
uwWam	uwWa<vargaH:nA><lifgam:napuM><viBakwiH:1><vacanam:1>
uwWApayawi	ux_sWA1_Nic<prayogaH:karwari><lakAraH:lat><puruRaH:pra><vacanam:1><paxI:parasmEpaxI><XAwuH:svIkq><gaNaH:BvAxiH><level:1>
uwwarAyaNaH	uwwarAyaNa<vargaH:nA><lifgam:puM><viBakwiH:1><vacanam:1><level:1>
uwwiRTamAnaH	uwwiRTamAna<vargaH:nA><lifgam:puM><viBakwiH:1><vacanam:1><level:1>
uxaGoRayaw	uw_GuR1<prayogaH:karwari><lakAraH:laf><puruRaH:pra><vacanam:1><paxI:parasmEpaxI><XAwuH:GuRir><gaNaH:curAxiH><level:1>
uxaGoRya	ux_GuR1<vargaH:avy><kqw_prawyayaH:lyap><XAwuH:GuRi><gaNaH:BvAxiH><level:0>$/uxGoRya	ux_GuR2<vargaH:avy><kqw_prawyayaH:lyap><XAwuH:GuRir><gaNaH:BvAxiH><level:0>/uxGoRya	ux_GuR3<vargaH:avy><kqw_prawyayaH:lyap><XAwuH:GuRir><gaNaH:curAxiH><level:0>$
uxaGoRya	ux_GuR1<vargaH:avy><kqw_prawyayaH:lyap><XAwuH:GuRi><gaNaH:BvAxiH><level:0>/ux_GuR2<vargaH:avy><kqw_prawyayaH:lyap><XAwuH:GuRir><gaNaH:BvAxiH><level:0>/ux_GuR3<vargaH:avy><kqw_prawyayaH:lyap><XAwuH:GuRir><gaNaH:curAxiH><level:0>
uxaGoRyaw	uw_GuR1<prayogaH:karwari><lakAraH:laf><puruRaH:pra><vacanam:1><paxI:parasmEpaxI><XAwuH:GuRir><gaNaH:curAxiH><level:1>
uxAsInavaw	uxAsInavaw<vargaH:avy><level:1>
uxGoRayan	uxGoRayaw<vargaH:nA><lifgam:puM><viBakwiH:1><vacanam:1><level:1>
uxGoRayanwam	uxGoRayaw<vargaH:nA><lifgam:puM><viBakwiH:2><vacanam:1><level:1>
uxGoRayanwi	uw_GuR1<prayogaH:karwari><lakAraH:lat><puruRaH:pra><vacanam:3><paxI:parasmEpaxI><XAwuH:GuRir><gaNaH:curAxiH><level:0>
uxGoRiwaH	uxGoRiwa<vargaH:nA><lifgam:puM><viBakwiH:1><vacanam:1><level:1>
uxGoRya	ux_GuR1<vargaH:avy><kqw_prawyayaH:lyap><XAwuH:GuRi><gaNaH:BvAxiH><level:0>$/uxGoRya	ux_GuR2<vargaH:avy><kqw_prawyayaH:lyap><XAwuH:GuRir><gaNaH:BvAxiH><level:0>/uxGoRya	ux_GuR3<vargaH:avy><kqw_prawyayaH:lyap><XAwuH:GuRir><gaNaH:curAxiH><level:0>$
uxGoRya	ux_GuR1<vargaH:avy><kqw_prawyayaH:lyap><XAwuH:GuRi><gaNaH:BvAxiH><level:0>/ux_GuR2<vargaH:avy><kqw_prawyayaH:lyap><XAwuH:GuRir><gaNaH:BvAxiH><level:0>/ux_GuR3<vargaH:avy><kqw_prawyayaH:lyap><XAwuH:GuRir><gaNaH:curAxiH><level:0>
uxXarew	uw_hq1<prayogaH:karwari><lakAraH:viXilif><puruRaH:pra><vacanam:1><paxI:parasmEpaxI>uw_hqF><gaNaH:BvAxiH>
uxxeSawaH	uxxeSa<vargaH:avy><level:1>
uxyanwam	uxyaw<vargaH:nA><lifgam:puM><viBakwiH:2><vacanam:1><level:1
vAcanAlayam	vAcanAlaya<vargaH:nA><lifgam:napuM><viBakwiH:2><vacanam:1><level:1>
vacArayanwi	vi_cara1_Nic<prayogaH:karwari><lakAraH:lat><puruRaH:pra><vacanam:3><paxI:parasmEpaxI><XAwuH:cara><gaNaH:BvAdiH><level:1>
vanaBojAya	vanaBoja<vargaH:nA><lifgam:puM><viBakwiH:4><vacanam:1><level:1>
varRaBogyeNa	varRaBogya<vargaH:nA><lifgam:puM><viBakwiH:3><vacanam:1><level:1>
vArwAlApam	vArwAlApa<vargaH:nA><lifgam:puM><viBakwiH:2><vacanam:1><level:1>
varweyam	vqw1<prayogaH:karwari><lakAraH:viXilif><puruRaH:u><vacanam:1><paxI:AwmanepaxI>vqwuz><gaNaH:BvAxiH>
varwsyanwO	varwsyan<vargaH:nA><lifgam:puM><viBakwiH:1><vacanam:2><level:1>
vAwAvaraNam	vAwAvaraNa<vargaH:nA><lifgam:napuM><viBakwiH:1><vacanam:1><level:1>
vAwAvaraNe	vAwAvaraNa<vargaH:nA><lifgam:napuM><viBakwiH:7><vacanam:1><level:1>
vaXaM	vaXa<vargaH:nA><lifgam:puM><viBakwiH:2><vacanam:1><level:1>
vAyuyAnAni	vAyuyAna<vargaH:nA><lifgam:puM><viBakwiH:1><vacanam:3><level:1>
vgqhiNaH	vqghin<vargaH:nA><lifgam:puM><viBakwiH:1><vacanam:3><level:1>
vicAlayew	vi_cal3<prayogaH:karwari><lakAraH:viXilif><puruRaH:pra><vacanam:1><paxI:parasmEpaxI><XAwuH:calaz><gaNaH:curAxiH>
vicAlyawe	vi_cal1_Nic<prayogaH:karmaNi><lakAraH:lat><puruRaH:pra><vacanam:1><paxI:parasmEpaxI><XAwuH:calaz><gaNaH:BvAxiH>/vi_cal3<prayogaH:karmaNi><lakAraH:lat><puruRaH:pra><vacanam:1><paxI:AwmanepaxI><XAwuH:calaz><gaNaH:curAxiH>
vicArayiwum	vi_car1_Nic<vargaH:avy><kqw_prawyayaH:wumun><XAwuH:cara><gaNaH:BvAxiH>
vIjayAmi	vi_Ij1_Nic<prayogaH:karwari><lakAraH:lat><puruRaH:u><vacanam:1><paxI:parasmEpaxI><XAwuH:ija><gaNaH:BvAxiH><level:1>
vijFApayAmAsa	vi_jFA1_Nic<prayogaH:karwari><lakAraH:lit><puruRaH:pra><vacanam:1><paxI:parasmEpaxI><XAwuH:jFA><gaNaH:curAxiH><level:1>
vijFApayanwaH	vijFApayaw<vargaH:nA><lifgam:puM><viBakwiH:1><vacanam:3><level:1>
vIkRanwe	vi_IkR1<prayogaH:karwari><lakAraH:lat><puruRaH:pra><vacanam:3><paxI:AwmanepaxI><XAwuH:IkRaz><gaNaH:BvAxiH>
vikrayikANAm	vikrayika<vargaH:nA><lifgam:puM><viBakwiH:6><vacanam:3><level:1>
vikRipan	vi_kRip1<prayogaH:karwari><lakAraH:laf><puruRaH:pra><vacanam:3><paxI:parasmEpaxI><XAwuH:kRip><gaNaH:xivAxiH><level:1>
vilapan	vi_lap1<kqw_prawyayaH:Sawq_lat><XAwuH:lapaz><gaNaH:BvAxiH><level:0><kqw_pratipadika:vilapaw><vargaH:nA><lifgam:puM><viBakwiH:1><vacanam:1>
vilapanwI	vilapanwI<vargaH:nA><lifgam:swrI><viBakwiH:1><vacanam:1><level:1>
vilApayase	vi_lap1<prayogaH:karwari><lakAraH:lot><puruRaH:maXya><vacanam:1><paxI:parasmEpaxI><XAwuH:lap><gaNaH:BvAxiH><level:0>
vilapiwum	vi_lap1<vargaH:avy><kqw_prawyayaH:wumun><XAwuH:lapa><gaNaH:BvAxiH>
vilopayawi	vi_lup1_Nic<prayogaH:karwari><lakAraH:lat><puruRaH:pra><vacanam:1><paxI:parasmEpaxI><XAwuH:svIkq><gaNaH:wanAxiH><level:1>
vimohayawi	vi_muh1_Nic<prayogaH:karwari><lakAraH:lat><puruRaH:pra><vacanam:1><paxI:parasmEpaxI><XAwuH:muhaz><gaNaH:xivAxiH>
vimokRyase	vi_muc1<prayogaH:karwari><lakAraH:lqt><puruRaH:ma><vacanam:1><paxI:AwmanepaxI><XAwuH:mucLz><gaNaH:wuxAxiH>
vimuFcawi	vi_muc1<prayogaH:karwari><lakAraH:lat><puruRaH:pra><vacanam:1><paxI:parasmEpaxI><XAwuH:mucLz><gaNaH:wuxAxiH>
vinafkRyasi	vi_naS1<prayogaH:karwari><lakAraH:lqt><puruRaH:ma><vacanam:1><paxI:parasmEpaxI><XAwuH:NaSaz><gaNaH:xivAxiH>
vinamayya	vi_Nam1<vargaH:avy><kqw_prawyayaH:lyap><XAwuH:Nama><gaNaH:BvAxiH><level:0>
vinamayya	vi_Nam1<vargaH:avy><kqw_prawyayaH:lyap><XAwuH:Nama><gaNaH:BvAxiH><level:0>$
vinaSyanwam	vi_naS1<kqw_prawyayaH:Sawq_lat><XAwuH:NaSaz><gaNaH:xivAxiH><lifgam:puM><viBakwiH:2><vacanam:1>
vinaSyawi	vi_naS1<prayogaH:karwari><lakAraH:lat><puruRaH:pra><vacanam:1><paxI:parasmEpaxI><XAwuH:NaSaz><gaNaH:xivAxiH>
vinaSyawsu	vi_naS1<kqw_prawyayaH:Sawq_lat><XAwuH:NaSaz><gaNaH:xivAxiH><lifgam:puM><viBakwiH:7><vacanam:3>
vininxan	vininxaw<vargaH:nA><lifgam:puM><viBakwiH:1><vacanam:1><level:1>
vinivexya	vi_ni_vix1<vargaH:avy><kqw_prawyayaH:lyap><XAwuH:vix><gaNaH:axAxiH><level:0>
viniyojayiwum	vi_ni_yuj1<vargaH:avy><kqw_prawyayaH:wumun><XAwuH:yuja><gaNaH:curAxiH>
viniyojiwavAn	viniyojiwavaw<vargaH:nA><lifgam:puM><viBakwiH:1><vacanam:1><level:1>
vipakRiNaH	vipakRin<vargaH:nA><lifgam:puM><viBakwiH:1><vacanam:3><level:1>/vipakRin<vargaH:nA><lifgam:puM><viBakwiH:2><vacanam:3><level:1>/vipakRin<vargaH:nA><lifgam:puM><viBakwiH:5><vacanam:1><level:1>/vipakRin<vargaH:nA><lifgam:puM><viBakwiH:6><vacanam:1><level:1>
vipakRiNA	vipakRin<vargaH:nA><lifgam:puM><viBakwiH:3><vacanam:1><level:1>
viramawi	vi_ram1<prayogaH:karwari><lakAraH:lat><puruRaH:pra><vacanam:1><paxI:parasmEpaxI><XAwuH:ramu><gaNaH:BvAxiH><level:1>
viramawu	vi_ram1<prayogaH:karwari><lakAraH:lot><puruRaH:pra><vacanam:1><paxI:parasmEpaxI><XAwuH:ramu><gaNaH:BvAxiH><level:1>
virarAma	vi_ram1<prayogaH:karwari><lakAraH:lit><puruRaH:pra><vacanam:1><paxI:AwmanepaxI><XAwuH:ramuz><gaNaH:BvAxiH><level:0>
viSawi	viS1<prayogaH:karwari><lakAraH:lat><puruRaH:pra><vacanam:1><paxI:parasmEpaxI><XAwuH:viSa><gaNaH:BvAxiH><level:1>
viSoXya	vi_SuX1<vargaH:avy><kqw_prawyayaH:lyap><XAwuH:SuX>u<gaNaH:xivAxiH><level:0>
viSramiwum	vi_Sram1<vargaH:avy><kqw_prawyayaH:wumun><XAwuH:Sramu><gaNaH:xivAxiH>
viswaraSaH	viswaraSaH<vargaH:avy><level:1>
vivAsayAmAsa	vi_vas1<prayogaH:karwari><lakAraH:lit><puruRaH:pra><vacanam:1><paxI:AwmanepaxI><XAwuH:vas><gaNaH:curAxiH><level:0>
vivekAnanxaH	vivekAnanxa<vargaH:nA><lifgam:puM><viBakwiH:1><vacanam:1><level:1>
vivekAnanxe	vivekAnanxa<vargaH:nA><lifgam:puM><viBakwiH:7><vacanam:1><level:1>
viveSa	vi_viS1<prayogaH:karwari><lakAraH:lit><puruRaH:pra><vacanam:1><paxI:parasmEpaxI><XAwuH:viSaz><gaNaH:wuxAxiH><level:0>
viwarakaH	viwaraka<vargaH:nA><lifgam:puM><viBakwiH:1><vacanam:1><level:1>
vixArya	vi_xQ1_Nic<vargaH:avy><kqw_prawyayaH:lyap><XAwuH:vi_xQ><gaNaH:curAdiH><level:0>
vixArya	vi_xQ1_Nic<vargaH:avy><kqw_prawyayaH:lyap><XAwuH:xQ><gaNaH:curAdiH><level:0>
vixyamAnaM	vixyamAna<vargaH:nA><lifgam:puM><viBakwiH:2><vacanam:1><level:1>
vyaBURayawa	vi_BUR1<prayogaH:karwari><lakAraH:laf><puruRaH:pra><vacanam:1><paxI:AwmanepaxI><XAwuH:BURa><gaNaH:curAxiH><level:1>
vyajijFapan	vi_jFA<prayogaH:karwari><lakAraH:laf><puruRaH:pra><vacanam:3><paxI:parasmEpaxI><XAwuH:jFA><gaNaH:BvAxiH><level:1>
vyanunAxayan	vi_anu_nax2<kqw_prawyayaH:Sawq_lat><XAwuH:Naxaz><gaNaH:curAxiH><lifgam:puM><viBakwiH:1><vacanam:1>
vyapASriwya	vi_apa_Af_Sri1<kqw_prawyayaH:lyap><XAwuH:SriF><gaNaH:BvAxiH>
vyaramaw	vi_ram1<prayogaH:karwari><lakAraH:laf><puruRaH:pra><vacanam:1><paxI:parasmEpaxI><XAwuH:ramu><gaNaH:BvAxiH><level:1>
vyaramayaw	vi_ramu<prayogaH:nic><lakAraH:laf><puruRaH:pra><vacanam:1><paxI:parasmEpaxI><XAwuH:ramu><gaNaH:BvAxiH><level:1>
vyasarjayaw	vi_sq2<prayogaH:karwari><lakAraH:laf><puruRaH:pra><vacanam:1><paxI:parasmEpaxI><XAwuH:sqj><gaNaH:wuxAxiH><level:0>
vyavahAraSIlaH	vyavahAraSIla<vargaH:nA><lifgam:puM><viBakwiH:1><vacanam:1><level:1>
vyavahAraSIlam	vyavahAraSIla<vargaH:nA><lifgam:napuM><viBakwiH:1><vacanam:1><level:1>
vyavahAraSIlA	vyavahAraSIlA<vargaH:nA><lifgam:swrI><viBakwiH:1><vacanam:1><level:1>
vyavasAyinaH	vyavasAyin<vargaH:nA><lifgam:puM><viBakwiH:6><vacanam:1><level:1>
vyavasAyinam	vyavasAyin<vargaH:nA><lifgam:puM><viBakwiH:2><vacanam:1><level:1>
vyavasAyinAm	vyavasAyin<vargaH:nA><lifgam:puM><viBakwiH:6><vacanam:3>
vyavasAyinoH	vyavasAyin<vargaH:nA><lifgam:puM><viBakwiH:6><vacanam:2><level:1>
vyaWaH	vyaWa<vargaH:nA><lifgam:puM><viBakwiH:1><vacanam:1>
vyaWanwi	vyaW1<prayogaH:karwari><lakAraH:lat><puruRaH:pra><vacanam:3><paxI:parasmEpaxI><XAwuH:vyaWaz><gaNaH:BvAxiH>
vyaWiRTAH	vyaWiRTa<vargaH:nA><lifgam:puM><viBakwiH:1><vacanam:3>
vyaxArayaw	vi_xQ2_Nic<prayogaH:karwari><lakAraH:laf><puruRaH:pra><vacanam:1><paxI:parasmEpaxI><XAwuH:xQ><gaNaH:kryAxiH>
wapassvAXyAyanirawam	wapassvAXyAyanirawa<vargaH:nA><lifgam:puM><viBakwiH:2><vacanam:1><level:1>
wapasyasi	wap2<prayogaH:karwari><lakAraH:lqt><puruRaH:ma><vacanam:1><paxI:parasmEpaxI><XAwuH:wapaz><gaNaH:xivAxiH>
wAtakA	wAtakA<vargaH:nA><lifgam:swrI><viBakwiH:1><vacanam:1><level:1>
wawkAlameva	wawkAlameva<vargaH:avy><level:1>
wawvaM	wawva<vargaH:nA><lifgam:napuM><viBakwiH:1><vacanam:1><level:1>नि
wimifgalAH	wimifgala<vargaH:nA><lifgam:puM><viBakwiH:1><vacanam:3><level:1>
wiwwilikAH	wiwwilikA<vargaH:nA><lifgam:swrI><viBakwiH:1><vacanam:3><level:1>
wvaramANAH	wvar1<kqw_prawyayaH:kwa><XAwuH:FiwvarAz><gaNaH:BvAxiH><lifgam:puM><viBakwiH:1><vacanam:3>
wyAjayiwum	wyaj1_Nic<vargaH:avy><kqw_prawyayaH:wumun><XAwuH:wyaja><gaNaH:BvAxiH>
xampawI	xampawI<vargaH:nA><lifgam:swrI><viBakwiH:2><vacanam:2><level:1>/xampawI<vargaH:nA><lifgam:swrI><viBakwiH:1><vacanam:2><level:1>
xampawyoH	xampawI<vargaH:nA><lifgam:swrI><viBakwiH:6><vacanam:2><level:1>
XanarASim	XanarASi<vargaH:nA><lifgam:swrI><viBakwiH:2><vacanam:1><level:1>
xanxahyawe	xah1_yaf<prayogaH:karwari><lakAraH:lat><puruRaH:pra><vacanam:1><paxI:parasmEpaxI><XAwuH:xah><gaNaH:BvAxiH><level:0>
xApayiwvA	xAp1<vargaH:avy><kqw_prawyayaH:kwvA><XAwuH:xApa><gaNaH:curAxiH><level:0>
XarAwale	XarAwala<vargaH:nA><lifgam:napuM><viBakwiH:7><vacanam:1><level:1>
XArayan	Xq1_Nic<kqw_prawyayaH:Sawq_lat><XAwuH:XqF><gaNaH:BvAxiH><lifgam:puM><viBakwiH:1><vacanam:1>
XArayiwvA	Xq1<vargaH:avy><kqw_prawyayaH:kwvA><XAwuH:XqF><gaNaH:BvAxiH><level:0>
xarSayan	xarSayaw<vargaH:nA><lifgam:puM><viBakwiH:1><vacanam:1><level:1>
xarSayiwum	xqS1<vargaH:avy><kqw_prawyayaH:wumun><XAwuH:xqSir><gaNaH:BvAxiH>
xarSayiwvA	xqS<vargaH:avy><kqw_prawyayaH:kwvA><XAwuH:xqSr><gaNaH:BvAxiH><level:0>
XAryawe	XAryawA<vargaH:nA><lifgam:swrI><viBakwiH:1><vacanam:2>/XAryawA<vargaH:nA><lifgam:swrI><viBakwiH:2><vacanam:2>/XAryawA<vargaH:nA><lifgam:swrI><viBakwiH:8><vacanam:1>/XAryawA<vargaH:nA><lifgam:swrI><viBakwiH:8><vacanam:2>
xaSavAxane	xaSavAxana<vargaH:nA><lifgam:napuM><viBakwiH:7><vacanam:1><level:1>
xravawi	xrav1<prayogaH:karwari><lakAraH:lat><puruRaH:pra><vacanam:3><paxI:parasmEpaxI><XAwuH:xrav><gaNaH:BvAxiH>
Xuk	Xuk<vargaH:nA><lifgam:puM><viBakwiH:1><vacanam:1>/Xuk<vargaH:nA><lifgam:swrI><viBakwiH:1><vacanam:1>
xurAcaraNam	xurAcaraNa<vargaH:nA><lifgam:na><viBakwiH:2><vacanam:1><level:1>
xUravIkRaNena	xUravIkRaNa<vargaH:nA><lifgam:napuM><viBakwiH:3><vacanam:1><level:1>
xurGatanAm	xurGatanA<vargaH:nA><lifgam:swrI><viBakwiH:2><vacanam:1><level:1>
xurGatanA	xurGatanA<vargaH:nA><lifgam:swrI><viBakwiH:1><vacanam:1><level:1>
xurguNavawi	xurguNavawI<vargaH:nA><lifgam:swrI><viBakwiH:7><vacanam:1><level:1>
xUrIBaviRyawi	xUrI_BU1<prayogaH:karwari><lakAraH:lqt><puruRaH:pra><vacanam:1><paxI:parasmEpaxI><XAwuH:BU><gaNaH:BvAxiH><level:1>
xUrIkarwum	xUrI_kq1<vargaH:avy><kqw_prawyayaH:wumun><XAwuH:dukqF><gaNaH:wanAxiH>
xuRkqwye	xuRkqwya<vargaH:nA><lifgam:napuM><viBakwiH:7><vacanam:1><level:1>
xviwrivarRIyaH	xviwrivarRIya<vargaH:nA><lifgam:puM><viBakwiH:1><vacanam:1><level:1>
yApayiwum	yA1_Nic<vargaH:avy><kqw_prawyayaH:wumun><XAwuH:yA><gaNaH:axAxiH>
yaWAkaWaFciw	yaWAkaWaFciw<vargaH:avy><level:1>
yawanwaH	yaw1<kqw_prawyayaH:Sawq_lat><XAwuH:yawIz><gaNaH:BvAxiH><kqw_pratipadika:yawaw><vargaH:nA><lifgam:puM><viBakwiH:1><vacanam:3>
yawanwi	yaw1<prayogaH:karwari><lakAraH:lat><puruRaH:pra><vacanam:3><paxI:parasmEpaxI><XAwuH:yawIz><gaNaH:BvAxiH>
yawawi	yaw1<prayogaH:karwari><lakAraH:lat><puruRaH:pra><vacanam:1><paxI:parasmEpaxI><XAwuH:yawIz><gaNaH:BvAxiH>
parixahyawe	pari_xah1<prayogaH:karmaNi><lakAraH:lat><puruRaH:pra><vacanam:1><paxI:AwmanepaxI><XAwuH:xahaz><gaNaH:BvAxiH>
uwsAxyanwe	uw_sax1_Nic<prayogaH:karmaNi><lakAraH:lat><puruRaH:pra><vacanam:3><paxI:AwmanepaxI><XAwuH:RaxLz><gaNaH:BvAxiH>
yAwriNaH	yAwrin<vargaH:nA><lifgam:puM><viBakwiH:1><vacanam:3><level:1>/yAwrin<vargaH:nA><lifgam:puM><viBakwiH:2><vacanam:3><level:1>/yAwrin<vargaH:nA><lifgam:puM><viBakwiH:5><vacanam:1><level:1>/yAwrin<vargaH:nA><lifgam:puM><viBakwiH:6><vacanam:1><level:1>
yAwriNAm	yAwrin<vargaH:nA><lifgam:puM><viBakwiH:6><vacanam:3><level:1>
yowsyamAnAn	yowsyamAna<vargaH:nA><lifgam:puM><viBakwiH:2><vacanam:3>
yoXapuram	yoXapura<vargaH:nA><lifgam:puM><viBakwiH:2><vacanam:1><level:1>
zZ	zZ<vargaH:avy><level:1>
